Unglücksfälle	NN	Unglücksfall
und	KON	und
Verbrechen	NN	Verbrechen
.	$.	.
—	$,	—
In	APPR	in
der	ART	die
Spinnerei	NN	Spinnerei
Winkler	NE	Winkler
im	APPRART	in+die
Friedthal-Turbenthal	NE	Friedthal-Turbenthal
gerieth	NE	gerieth
auf	APPR	auf
noch	ADV	noch
nicht	PTKNEG	nicht
ganz	ADV	ganz
aufgeklärte	ADJA	aufgeklärt
Art	NN	Art
und	KON	und
Weise	NN	Weise
die	ART	die
Baumwolle	NN	Baumwolle
in	APPR	in
Brand	NE	Brand
.	$.	.
Das	ART	die
Fabrikgebäude	NN	Fabrikgebäude
blieb	VVFIN	bleiben
unversehrt	ADJD	unversehrt
;	$.	;
der	ART	die
Mobiliarschaden	NN	Mobiliarschaden
beträgt	VVFIN	betragen
blos	ADJD	blos
einige	PIAT	einige
hundert	CARD	hundert
Franken	NN	Franke
.	$.	.
Lokales	NN	Lokale
.	$.	.
—	$,	—
*	XY	*
Eidgen	NN	Eidgen
.	$.	.
Turnfest	NN	Turnfest
Basel	NE	Basel
.	$.	.
Das	ART	die
Kampfgericht	NN	Kampfgericht
hat	VAFIN	haben
dem	ART	die
Turnverein	NN	Turnverein
Hottingen	NN	Hottingen
den	ART	die
13	CARD	@card@
.	$.	.
statt	APPR	statt
des	ART	die
24	CARD	@card@
.	$.	.
Kranzes	NN	Kranz
zugesprochen	VVPP	zusprechen
.	$.	.
Die	ART	die
Kontrolle	NN	Kontrolle
ergab	VVFIN	ergeben
die	ART	die
Unrichtigkeit	NN	Unrichtigkeit
der	ART	die
ersten	ADJA	erst
Berechnung	NN	Berechnung
.	$.	.
—	$,	—
C	NN	C
Die	ART	die
Identität	NN	Identität
des	ART	die
hier	ADV	hier
in	APPR	in
Untersuchungshaft	NN	Untersuchungshaft
sitzenden	ADJA	sitzend
Postdiebes	NN	Postdiebes
,	$,	,
der	PRELS	die
sich	PRF	sich
bekanntlich	ADV	bekanntlich
„	$(	„
Burton	NN	Burton
”	NN	”
nannte	VVFIN	nennen
,	$,	,
ist	VAFIN	sein
nunmehr	ADV	nunmehr
festgestellt	VVPP	feststellen
.	$.	.
In	APPR	in
der	ART	die
Verbrecherwelt	NN	Verbrecherwelt
,	$,	,
in	APPR	in
welche	PRELS	welche
dieser	PDAT	dies
Postdieb	NN	Postdieb
eine	ART	eine
große	ADJA	groß
Rolle	NN	Rolle
spielte	VVFIN	spielen
,	$,	,
nennt	VVFIN	nennen
man	PIS	man
ihn	PPER	er
„	$(	„
old	ADJA	old
horse	NN	horse
”	ADJA	”
(	$(	(
altes	ADJA	alt
Roß	NN	Ross
)	$(	)
;	$.	;
sein	PPOSAT	sein
bürgerlicher	ADJA	bürgerlich
Name	NN	Name
ist	VAFIN	sein
Thomas	NE	Thomas
Sansum	NN	Sansum
.	$.	.
Nach	APPR	nach
Zürich	NE	Zürich
kam	VVFIN	kommen
auch	ADV	auch
die	ART	die
angebliche	ADJA	angeblich
Frau	NN	Frau
des	ART	die
Verbrechers	NN	Verbrecher
,	$,	,
Sarah	NE	Sarah
Clayton	NE	Clayton
,	$,	,
gereist	VVPP	reisen
;	$.	;
sie	PPER	sie
ist	VAFIN	sein
ebenfalls	ADV	ebenfalls
verhaftet	VVPP	verhaften
.	$.	.
Beide	PIS	beide
sind	VAFIN	sein
Irländer	NN	Irländer
.	$.	.
Um	APPR	um
sich	PRF	sich
von	APPR	von
dem	ART	die
Vorleben	NN	Vorleben
des	ART	die
sauberen	ADJA	sauber
Paares	NN	Paar
einen	ART	eine
Begriff	NN	Begriff
zu	PTKZU	zu
machen	VVINF	machen
,	$,	,
genügt	VVFIN	genügen
es	PPER	es
zu	PTKZU	zu
wissen	VVINF	wissen
,	$,	,
daß	KOUS	dass
Sansum	NN	Sansum
im	APPRART	in+die
Ganzen	NN	Ganze
bereits	ADV	bereits
zu	APPR	zu
33	CARD	@card@
Jahren	NN	Jahr
Gefängniß	NN	Gefängniß
,	$,	,
seine	PPOSAT	sein
bessere	ADJA	gut
Hälfte	NN	Hälfte
zu	APPR	zu
12	CARD	@card@
1/2	CARD	@card@
Jahren	NN	Jahr
Gefängniß	NN	Gefängniß
verurtheilt	VVPP	verurtheilt
wurde	VAFIN	werden
.	$.	.
