*	XY	*
*	XY	*
Aus	NN	Aus
Bilseck	NN	Bilseck
.	$.	.
Wie	KOUS	wie
wir	PPER	wir
hören	VVFIN	hören
,	$,	,
ist	VAFIN	sein
nunmehr	ADV	nunmehr
die	ART	die
Eisenbahn	NN	Eisenbahn
=	$(	=
Linie	NN	Linie
von	APPR	von
Weiden	NN	Weide|Weiden
ab	PTKVZ	ab
durch	APPR	durch
den	ART	die
Landgerichtsbezirk	NN	Landgerichtsbezirk
Vilseck	NN	Vilseck
in	APPR	in
der	ART	die
Hauptsache	NN	Hauptsache
definitiv	ADJD	definitiv
festgestellt	VVPP	feststellen
.	$.	.
Es	PPER	es
werden	VAFIN	werden
hiedurch	ADV	hiedurch
für	APPR	für
die	ART	die
Eisen	NN	Eisen
=	$(	=
Industrie	NN	Industrie
in	APPR	in
Schwarzberg	NE	Schwarzberg
und	KON	und
den	ART	die
Absatz	NN	Absatz
der	ART	die
staatlichen	ADJA	staatlich
Forstprodukte	NN	Forstprodukt
Folgen	NN	Folge
von	APPR	von
höchster	ADJA	hoch
Wichtigkeit	NN	Wichtigkeit
eintreten	VVINF	eintreten
.	$.	.
Namentlich	ADJD	namentlich
stellt	VVFIN	stellen
sich	PRF	sich
als	KOKOM	als
Perspektive	NN	Perspektive
für	APPR	für
die	ART	die
Staats	NN	Staat
=	$(	=
Einnahme	NN	Einnahme
eine	ART	eine
sehr	ADV	sehr
große	ADJA	groß
Mehrung	NN	Mehrung
heraus	PTKVZ	heraus
,	$,	,
da	KOUS	da
der	ART	die
Werth	NN	Werth
des	ART	die
ärarialischen	ADJA	ärarialischen
Torfvorrathes	NE	Torfvorrathes
zu	APPR	zu
Röthelweiher	NN	Röthelweiher
zwischen	APPR	zwischen
zwei	CARD	zwei
bis	KON	bis
drei	CARD	drei
Millionen	NN	Million
Gulden	NN	Gulden
beträgt	VVFIN	betragen
und	KON	und
der	ART	die
Staat	NN	Staat
im	APPRART	in+die
Stande	NN	Stand
ist	VAFIN	sein
,	$,	,
den	ART	die
Torf	NN	Torf
vom	APPRART	von+die
Stiche	NN	Stich
weg	ADV	weg
sofort	ADV	sofort
per	APPR	per
Bahn	NN	Bahn
weiter	ADV	weiter
zu	PTKZU	zu
liefern	VVINF	liefern
und	KON	und
der	ART	die
Torfnutzung	NN	Torfnutzung
eine	ART	eine
ganz	ADV	ganz
beliebige	ADJA	beliebig
Ausdehnung	NN	Ausdehnung
zu	PTKZU	zu
geben	VVINF	geben
,	$,	,
vorausgesetzt	VVPP	voraussetzen
,	$,	,
daß	KOUS	dass
die	ART	die
Forstverwaltung	NN	Forstverwaltung
sich	PRF	sich
entschließt	VVFIN	entschließen
,	$,	,
aus	APPR	aus
dem	ART	die
Röthelweiher	NN	Röthelweiher
bis	KON	bis
zur	APPRART	zu+die
Lagerstelle	NN	Lagerstelle
eine	ART	eine
kleine	ADJA	klein
Eisenbahn	NN	Eisenbahn
zu	PTKZU	zu
erbauen	VVINF	erbauen
,	$,	,
was	PRELS	was
nach	APPR	nach
der	ART	die
Versicherung	NN	Versicherung
kompetenter	ADJA	kompetent
Sachverständiger	NN	Sachverständige
wohl	ADV	wohl
nur	ADV	nur
verhältnißmäßig	ADJD	verhältnißmäßig
geringe	ADJA	gering
Kosten	NN	Kosten
erfordern	VVINF	erfordern
kann	VMFIN	können
.	$.	.
Hoffen	VVFIN	hoffen
wir	PPER	wir
,	$,	,
daß	KOUS	dass
dieser	PDAT	dies
Punkt	NN	Punkt
gerade	ADV	gerade
jetzt	ADV	jetzt
für	APPR	für
die	ART	die
Frage	NN	Frage
der	ART	die
Steuer	NN	Steuer
=	$(	=
Erhöhung	NN	Erhöhung
geeignete	ADJA	geeignet
Würdigung	NN	Würdigung
findet	VVFIN	finden
.	$.	.
