(	$(	(
Locales	NN	Locales
.	$.	.
)	$(	)
Der	ART	die
17jährige	ADJA	17jährig
Prakticant	NN	Prakticant
Rudolph	NE	Rudolph
Sch	VVFIN	Sch
.	$.	.
erhielt	VVFIN	erhalten
am	APPRART	an+die
9	CARD	@card@
.	$.	.
d.	ART	d.
M.	NE	M.
von	APPR	von
seinen	PPOSAT	sein
Chefs	NN	Chef
,	$,	,
den	PRELS	die
in	APPR	in
der	ART	die
Spiegelgasse	NN	Spiegelgasse
Nr.	NN	Nr.
21	CARD	@card@
etablirten	NN	etablirten
Juwelieren	NN	Juwelieren
Gebrüder	NN	Gebrüder
Figdor	VVFIN	Figdor
den	ART	die
Auftrag	NN	Auftrag
,	$,	,
ein	ART	eine
mit	APPR	mit
Schmuckgegenständen	NN	Schmuckgegenständen
im	APPRART	in+die
Werthe	NN	Werthe
von	APPR	von
über	APPR	über
700	CARD	@card@
fl	NN	fl
.	$.	.
beschwertes	ADJA	beschwertes
Paket	NN	Paket
mittelst	ADJD	mittel
Post	NN	Post
an	APPR	an
seine	PPOSAT	sein
Adresse	NN	Adresse
abzuschicken	VVIZU	abschicken
.	$.	.
Der	ART	die
junge	ADJA	jung
Mann	NN	Mann
eignete	VVFIN	eignen
sich	PRF	sich
aber	ADV	aber
die	ART	die
anvertrauten	ADJA	anvertraut
Schmuckgegenstände	NN	Schmuckgegenstand
an	PTKVZ	an
und	KON	und
wurde	VAFIN	werden
gestern	ADV	gestern
nach	APPR	nach
der	ART	die
Entdeckung	NN	Entdeckung
des	ART	die
Verbrechens	NN	Verbrechen
ﬂüchtig	ADJD	ﬂüchtig
.	$.	.
Das	ART	die
Polizeicommissariat	NN	Polizeicommissariat
in	APPR	in
der	ART	die
inneren	ADJA	inner
Stadt	NN	Stadt
,	$,	,
welches	PRELS	welche
gestern	ADV	gestern
von	APPR	von
dem	ART	die
geschehenen	ADJA	geschehen
Unterschleife	NN	Unterschleife
in	APPR	in
Kenntniß	NN	Kenntniß
gesetzt	VVPP	setzen
wurde	VAFIN	werden
,	$,	,
hat	VAFIN	haben
die	ART	die
steckbriefliche	ADJA	steckbriefliche
Verfolgung	NN	Verfolgung
des	ART	die
Defraudanten	NN	Defraudanten
ungesäumt	ADJD	ungesäumt
angeordnet	VVPP	anordnen
.	$.	.
Der	ART	die
32jährige	ADJA	32jährig
Steindrucker	NN	Steindrucker
Rudolph	NE	Rudolph
Sch	VVFIN	Sch
.	$.	.
stand	VVFIN	stehen
seit	APPR	seit
einiger	PIAT	einige
Zeit	NN	Zeit
beim	APPRART	bei+die
k.	NN	k.
k.	NN	k.
Handelsgerichte	NN	Handelsgericht
in	APPR	in
Arbeit	NN	Arbeit
.	$.	.
Gestern	ADV	gestern
entdeckte	VVFIN	entdecken
man	PIS	man
,	$,	,
daß	KOUS	dass
der	ART	die
erwähnte	ADJA	erwähnt
Steindrucker	NN	Steindrucker
Wochen	NN	Woche
hindurch	ADV	hindurch
unbeschriebenes	ADJA	unbeschrieben
Conzeptpapier	NN	Conzeptpapier
entwendet	VVPP	entwenden
und	KON	und
dasselbe	PDAT	dasselb
Fragnern	NN	Fragnern
zu	APPR	zu
Spottpreisen	NN	Spottpreis
verkauft	VVPP	verkaufen
hat	VAFIN	haben
.	$.	.
Sch	VVFIN	Sch
.	$.	.
,	$,	,
welcher	PWAT	welche
schon	ADV	schon
ein	ART	eine
Mal	NN	Mal
wegen	APPR	wegen
Diebstahls	NN	Diebstahl
zu	APPR	zu
einer	ART	eine
zweimonatlichen	ADJA	zweimonatlich
Arreststrafe	NN	Arreststrafe
verurtheilt	ADJD	verurtheilt
worden	VAPP	werden
ist	VAFIN	sein
,	$,	,
wurde	VAFIN	werden
dem	ART	die
competenten	ADJA	competenten
Gerichte	NN	Gericht
übergeben	VVINF	übergeben
.	$.	.
