Vermischtes	NN	Vermischte
.	$.	.
Nürnberg	NE	Nürnberg
,	$,	,
28	CARD	@card@
.	$.	.
März	NN	März
.	$.	.
Heute	ADV	heute
Nachmittags	NN	Nachmittags
ist	VAFIN	sein
im	APPRART	in+die
Ostbahnhofe	NN	Ostbahnhofe
dahier	VVFIN	dahier
ein	ART	eine
Taglöhner	NN	Taglöhner
beim	APPRART	bei+die
Ausladen	NN	Ausladen
von	APPR	von
Baumstämmen	NN	Baumstamm
unter	APPR	unter
einen	ART	eine
Stamm	NN	Stamm
gekommen	VVPP	kommen
und	KON	und
wurde	VAFIN	werden
erdrückt	VVPP	erdrücken
.	$.	.
Würzburg	NE	Würzburg
,	$,	,
25	CARD	@card@
.	$.	.
März	NN	März
.	$.	.
Die	ART	die
vom	APPRART	von+die
Schwurgerichtshofe	NN	Schwurgerichtshofe
am	APPRART	an+die
20	CARD	@card@
.	$.	.
d.	ART	d.
wegen	APPR	wegen
Verbrechens	NN	Verbrechen
der	ART	die
Amtsuntreue	NN	Amtsuntreue
zu	APPR	zu
je	ADV	je
4	CARD	@card@
Jahren	NN	Jahr
Zuchthaus	NN	Zuchthaus
verurtheilten	VVFIN	verurtheilten
Johann	NE	Johann
Marx	NE	Marx
,	$,	,
Gemeindepfleger	NN	Gemeindepfleger
von	APPR	von
Rieneck	NE	Rieneck
und	KON	und
Johann	NE	Johann
Nöll	NE	Nöll
,	$,	,
Gemeindebevollmächtigter	NN	Gemeindebevollmächtigter
von	APPR	von
da	ADV	da
,	$,	,
haben	VAFIN	haben
nachträglich	ADJD	nachträglich
freiwillig	ADJD	freiwillig
vor	APPR	vor
dem	ART	die
Untersuchungsrichter	NN	Untersuchungsrichter
ein	ART	eine
vollständiges	ADJA	vollständig
Geständniß	NN	Geständniß
über	APPR	über
die	ART	die
bei	APPR	bei
der	ART	die
Auszahlung	NN	Auszahlung
der	ART	die
Kriegsentschädigungsgelder	NN	Kriegsentschädigungsgelder
vorgekommenen	ADJA	vorgekommen
Veruntreuungen	NN	Veruntreuung
abgelegt	VVPP	ablegen
.	$.	.
In	APPR	in
Folge	NN	Folge
dieses	PDAT	dies
Geständnisses	NN	Geständnis
wurden	VAFIN	werden
nun	ADV	nun
zwei	CARD	zwei
weitere	ADJA	weit
Mitglieder	NN	Mitglied
der	ART	die
Gemeindeverwaltung	NN	Gemeindeverwaltung
von	APPR	von
Rieneck	NN	Rieneck
in	APPR	in
Untersuchung	NN	Untersuchung
gezogen	VVPP	ziehen
.	$.	.
—	$,	—
Wie	KOUS	wie
man	PIS	man
vernimmt	VVFIN	vernehmen
,	$,	,
sollen	VMFIN	sollen
auch	ADV	auch
in	APPR	in
andern	PIAT	andere
Gemeinden	NN	Gemeinde
derartige	ADJA	derartig
Veruntreuungen	NN	Veruntreuung
vorgekommen	VVPP	vorkommen
sein	VAINF	sein
.	$.	.
