Lokales	NN	Lokale
.	$.	.
Gießen	NE	Gießen
,	$,	,
4	CARD	@card@
.	$.	.
August	NE	August
.	$.	.
Die	ART	die
bei	APPR	bei
dem	ART	die
gestrigen	ADJA	gestrig
Feuer	NN	Feuer
im	APPRART	in+die
Schmidt'schen	NN	Schmidt'schen
Hause	NN	Haus
am	APPRART	an+die
Canzleiberg	NN	Canzleiberg
verunglückte	ADJA	verunglückt
Näherin	NN	Näherin
befindet	VVFIN	befinden
sich	PRF	sich
den	ART	die
Umständen	NN	Umstand
gemäß	APPO	gemäß
in	APPR	in
sorgsamster	ADJA	sorgsamster
Pflege	NN	Pflege
und	KON	und
hofft	VVFIN	hoffen
man	PIS	man
,	$,	,
daß	KOUS	dass
sie	PPER	sie
mit	APPR	mit
dem	ART	die
Leben	NN	Leben
davon	PAV	davon
kommt	VVFIN	kommen
.	$.	.
Beiläufig	ADJD	beiläufig
bemerkt	VVPP	bemerken
sei	VAFIN	sein
hier	ADV	hier
,	$,	,
daß	KOUS	dass
Kindchen	NN	Kindchen
,	$,	,
welches	PRELS	welche
sie	PPER	sie
aus	APPR	aus
dem	ART	die
Fenster	NN	Fenster
warf	VVFIN	werfen
,	$,	,
bereits	ADV	bereits
1	CARD	@card@
3/4	CARD	@card@
Jahre	NN	Jahr
alt	ADJD	alt
ist	VAFIN	sein
(	$(	(
im	APPRART	in+die
November	NN	November
1884	CARD	@card@
geboren	VVPP	gebären
)	$(	)
.	$.	.
Seine	PPOSAT	sein
Mutter	NN	Mutter
befindet	VVFIN	befinden
sich	PRF	sich
seit	APPR	seit
Ende	NN	Ende
August	NN	August
1884	CARD	@card@
in	APPR	in
hiesiger	ADJA	hiesig
Stadt	NN	Stadt
.	$.	.
