Lokales	NN	Lokale
.	$.	.
Gießen	NE	Gießen
,	$,	,
7	CARD	@card@
.	$.	.
August	NE	August
.	$.	.
Gestern	ADV	gestern
Nachmittag	NN	Nachmittag
machte	VVFIN	machen
die	ART	die
Kleinkinderschule	NN	Kleinkinderschule
unter	APPR	unter
Führung	NN	Führung
einiger	PIAT	einige
Damen	NN	Dame
und	KON	und
Herren	NN	Herr
des	ART	die
Frauenvereins	NN	Frauenverein
und	KON	und
der	ART	die
Lehrerinnen	NN	Lehrerin
einen	ART	eine
Ausflug	NN	Ausflug
zur	APPRART	zu+die
„	$(	„
Liebigshöhe	NN	Liebigshöhe
”	ADJD	”
.	$.	.
Hier	ADV	hier
wurden	VAFIN	werden
die	ART	die
Kleinen	NN	Kleine
nach	APPR	nach
dem	ART	die
anstrengenden	ADJA	anstrengend
Marsche	NN	Marsche
mit	APPR	mit
Kaffee	NN	Kaffee
und	KON	und
Bretzeln	NN	Bretzeln
erquickt	VVPP	erquicken
.	$.	.
Leider	ADV	leider
wurde	VAFIN	werden
die	ART	die
Festesfreude	NN	Festesfreude
durch	APPR	durch
den	ART	die
anhaltenden	ADJA	anhaltend
Regen	NN	Regen
sehr	ADV	sehr
herabgedrückt	VVPP	herabdrücken
.	$.	.
—	$,	—
Die	ART	die
Zeit	NN	Zeit
für	APPR	für
Schwämmesucher	NN	Schwämmesucher
scheint	VVFIN	scheinen
gekommen	VVPP	kommen
zu	PTKZU	zu
sein	VAINF	sein
,	$,	,
denn	KON	denn
man	PIS	man
sieht	VVFIN	sehen
mancherlei	PIAT	mancherlei
Gestalten	NN	Gestalt|Gestalten
suchenden	ADJA	suchend
Blickes	NN	Blick
den	ART	die
„	$(	„
Trieb	NN	Trieb
”	ADJD	”
durchstreifen	VVINF	durchstreifen
.	$.	.
Bei	APPR	bei
dem	ART	die
anhaltenden	ADJA	anhaltend
feuchten	ADJA	feucht
Wetter	NN	Wetter
wird	VAFIN	werden
diese	PDAT	dies
Ernte	NN	Ernte
gut	ADJD	gut
ausfallen	VVINF	ausfallen
.	$.	.
—	$,	—
Wie	KOUS	wie
aus	APPR	aus
dem	ART	die
Inseratentheile	NN	Inseratentheile
ersichtlich	ADJD	ersichtlich
,	$,	,
hat	VAFIN	haben
die	ART	die
Ruder	NN	Ruder
=	$(	=
Gesellschaft	NN	Gesellschaft
das	ART	die
für	APPR	für
morgen	ADV	morgen
projectirte	ADJA	projectirte
Sommerfest	NN	Sommerfest
in	APPR	in
Anbetracht	NN	Anbetracht
der	ART	die
unbestimmten	ADJA	unbestimmt
Witterung	NN	Witterung
bis	KON	bis
auf	APPR	auf
Weiteres	NN	Weiter
verschoben	VVPP	verschieben
.	$.	.
