Vermischte	ADJA	vermischt
Nachrichten	NN	Nachricht
.	$.	.
†	ADJA	†
†	NN	†
Bayreuth	NE	Bayreuth
.	$.	.
18	CARD	@card@
.	$.	.
Mai	NE	Mai
.	$.	.
Bei	APPR	bei
der	ART	die
Liberalität	NN	Liberalität
,	$,	,
mit	APPR	mit
welcher	PRELS	welche
der	ART	die
reizende	ADJA	reizend
Park	NN	Park
der	ART	die
Fantaisie	NN	Fantaisie
dem	ART	die
Publikum	NN	Publikum
bisher	ADV	bisher
erschlossen	VVPP	erschließen
ist	VAFIN	sein
,	$,	,
war	VAFIN	sein
offenbar	ADJD	offenbar
auf	APPR	auf
schonende	ADJA	schonend
Benützung	NN	Benützung
der	ART	die
so	ADV	so
sorgfältig	ADJD	sorgfältig
gehaltenen	ADJA	gehalten
Anlagen	NN	Anlage
gerechnet	VVPP	rechnen
worden	VAPP	werden
.	$.	.
Wie	KOKOM	wie
wenig	PIS	wenige
stimmt	VVFIN	stimmen
es	PPER	es
nun	ADV	nun
zur	APPRART	zu+die
Rücksicht	NN	Rücksicht
,	$,	,
|die	NN	|die
man	PIS	man
dem	ART	die
so	ADV	so
wohlwollenden	ADJA	wohlwollend
Eigenthümer	NN	Eigenthümer
des	ART	die
wunderschönen	ADJA	wunderschön
Erhohlungsplatzes	NN	Erhohlungsplatzes
schuldet	VVFIN	schulden
,	$,	,
wenn	KOUS	wenn
man	PIS	man
,	$,	,
wie	KOUS	wie
gestern	ADV	gestern
ein	ART	eine
Herr	NN	Herr
v.	APPR	von
A.	NE	A.
sich	PRF	sich
herausnahm	VVFIN	herausnehmen
,	$,	,
aus	APPR	aus
den	ART	die
Fußwegen	NN	Fußweg
des	ART	die
Parkes	NN	Parkes
herumtreitet	VVFIN	herumtreitet
!	$.	!
*	XY	*
Bayreuth	NE	Bayreuth
,	$,	,
16	CARD	@card@
.	$.	.
Mai	NE	Mai
.	$.	.
Gestern	ADV	gestern
wurde	VAFIN	werden
ein	ART	eine
Israelite	NN	Israelite
,	$,	,
Namens	APPR	namens
B.	NE	B.
Strauß	NE	Strauß
,	$,	,
bei	APPR	bei
Poppendorf	NN	Poppendorf
erschlagen	VVPP	erschlagen
.	$.	.
Zwei	CARD	zwei
der	ART	die
That	NE	That
Verdächtige	NN	Verdächtige
sind	VAFIN	sein
eingezogen	VVPP	einziehen
.	$.	.
—	$,	—
Heute	ADV	heute
erhängte	VVFIN	erhängen
sich	PRF	sich
im	APPRART	in+die
Studentenwäldchen	NN	Studentenwäldchen
der	ART	die
Taglöhner	NN	Taglöhner
und	KON	und
ehemalige	ADJA	ehemalig
Gensdarm	NN	Gensdarm
,	$,	,
J.	APPR	j.
Ort	NN	Ort
,	$,	,
und	KON	und
in	APPR	in
der	ART	die
Altstadt	NN	Altstadt
ertrank	VVFIN	ertrinken
ein	ART	eine
Kind	NN	Kind
in	APPR	in
einer	ART	eine
Brunnenstube	NN	Brunnenstube
.	$.	.
