Kulmbach	NE	Kulmbach
,	$,	,
5	CARD	@card@
.	$.	.
Febr	NE	Febr
.	$.	.
Die	ART	die
Raufexcesse	NN	Raufexcesse
scheinen	VVFIN	scheinen
sich	PRF	sich
in	APPR	in
neuerer	ADJA	neu
Zeit	NN	Zeit
wieder	ADV	wieder
bedeutend	ADJD	bedeutend
zu	PTKZU	zu
mehren	VVINF	mehren
.	$.	.
So	ADV	so
wurde	VAFIN	werden
vorgestern	ADV	vorgestern
Nachts	ADV	nachts
einem	ART	eine
Arbeiter	NN	Arbeiter
von	APPR	von
Pröbitsch	NN	Pröbitsch
,	$,	,
Vater	NN	Vater
mehrerer	PIAT	mehrere
Kinder	NN	Kind
,	$,	,
in	APPR	in
einem	ART	eine
solchen	PIAT	solche
die	ART	die
Hirnschale	NN	Hirnschale
eingeschlagen	VVPP	einschlagen
,	$,	,
so	ADV	so
daß	KOUS	dass
er	PPER	er
gestern	ADV	gestern
morgens	ADV	morgens
im	APPRART	in+die
Hause	NN	Haus
des	ART	die
Arztes	NN	Arzt
,	$,	,
wohin	PWAV	wohin
er	PPER	er
gebracht	VVPP	bringen
wurde	VAFIN	werden
,	$,	,
verschied	VVFIN	verscheiden
.	$.	.
Der	ART	die
Thäter	NN	Thäter
sitzt	VVFIN	sitzen
bereits	ADV	bereits
hinter	APPR	hinter
Schloß	NN	Schloss
und	KON	und
Riegel	NN	Riegel
.	$.	.
