Aus	APPR	aus
dem	ART	die
Kreise	NN	Kreis
Malmedy	NE	Malmedy
.	$.	.
St.	NE	St.
Vith	NE	Vith
,	$,	,
den	ART	die
2	CARD	@card@
.	$.	.
Mai	NE	Mai
.	$.	.
Maiennacht	NN	Maiennacht
.	$.	.
Der	ART	die
Uebergang	NN	Uebergang
vom	APPRART	von+die
April	NN	April
in	APPR	in
den	ART	die
„	$(	„
Wonnemonat	NN	Wonnemonat
“	$(	“
Mai	NN	Mai
hat	VAFIN	haben
sich	PRF	sich
heuer	ADV	heuer
hinterm	APPRART	hinter+die
warmen	ADJA	warm
Ofen	NN	Ofen
vollzogen	VVPP	vollziehen
Sonntag	NN	Sonntag
(	$(	(
30	CARD	@card@
.	$.	.
April	NN	April
)	$(	)
vormittags	ADV	vormittags
fing	VVFIN	fangen
es	PPER	es
an	PTKVZ	an
zu	PTKZU	zu
schneien	VVINF	schneien
und	KON	und
es	PPER	es
schneite	VVFIN	schneien
unaufhörlich	ADJD	unaufhörlich
fort	PTKVZ	fort
bis	KON	bis
in	APPR	in
die	ART	die
Dunkelheit	NN	Dunkelheit
hinein	ADV	hinein
Musik	NN	Musik
=	$(	=
u.	APPR	um
Gesang	NN	Gesang
=	$(	=
Verein	NN	Verein
,	$,	,
die	PRELS	die
alljährlich	ADJD	alljährlich
den	ART	die
Mai	NN	Mai
mit	APPR	mit
den	ART	die
üblichen	ADJA	üblich
Liedern	NN	Lied
in	APPR	in
nächtlicher	ADJA	nächtlich
Stunde	NN	Stunde
begrüßen	VVFIN	begrüßen
,	$,	,
wären	VAFIN	sein
beinahe	ADV	beinahe
nicht	PTKNEG	nicht
zu	APPR	zu
ihrem	PPOSAT	ihr
traditionellen	ADJA	traditionell
Rechte	NN	Recht|Rechte
gekommen	VVPP	kommen
,	$,	,
wenn	KOUS	wenn
nicht	PTKNEG	nicht
noch	ADV	noch
spät	ADJD	spät
abends	ADV	abends
das	ART	die
Wetter	NN	Wetter
wenigstens	ADV	wenigstens
einigermaßen	ADV	einigermaßen
sich	PRF	sich
besser	ADJD	gut
gestellt	VVPP	stellen
hätte	VAFIN	haben
.	$.	.
So	ADV	so
konnten	VMFIN	können
sie	PPER	sie
denn	ADV	denn
ihr	PPOSAT	ihr
Recht	NN	Recht
behaupten	VVINF	behaupten
und	KON	und
diejenigen	PDS	diejenigen
,	$,	,
welche	PRELS	welche
schon	ADV	schon
in	APPR	in
der	ART	die
Voraussicht	NN	Voraussicht
,	$,	,
daß	KOUS	dass
die	ART	die
„	$(	„
Maiennacht	NN	Maiennacht
“	$(	“
ausfiele	VVFIN	ausfallen
,	$,	,
sich	PRF	sich
zur	APPRART	zu+die
Ruhe	NN	Ruhe
begeben	VVPP	begeben
hatten	VAFIN	haben
,	$,	,
in	APPR	in
wohltuender	ADJA	wohltuend
Weise	NN	Weise
aus	APPR	aus
dem	ART	die
Schlafe	NN	Schlaf
wecken	VVINF	wecken
und	KON	und
mit	APPR	mit
ihren	PPOSAT	ihr
Mailiedern	NN	Mailiedern
erfreuen	VVFIN	erfreuen
.	$.	.
Alle	PIS	alle
,	$,	,
die	PRELS	die
noch	ADV	noch
Sinn	NN	Sinn
für	APPR	für
Maienluft	NN	Maienluft
.	$.	.
u.	KON	und
=	$(	=
lieder	ADJD	lieder
haben	VAFIN	haben
,	$,	,
werden	VAFIN	werden
den	ART	die
Vereinen	NN	Verein|Vereinen
Dank	NN	Dank
wissen	VVINF	wissen
.	$.	.
