Heiß	ADJD	heiß
war	VAFIN	sein
es	PPER	es
heute	ADV	heute
,	$,	,
sehr	ADV	sehr
heiß	ADJD	heiß
,	$,	,
sagte	VVFIN	sagen
Fritz	NE	Fritz
Sonbert	NE	Sonbert
zu	APPR	zu
seinem	PPOSAT	sein
Vater	NN	Vater
,	$,	,
legte	VVFIN	legen
dann	ADV	dann
so	ADV	so
eben	ADV	eben
von	APPR	von
der	ART	die
Feldarbeit	NN	Feldarbeit
heimgekehrt	VVPP	heimkehren
das	ART	die
Grabscheit	NN	Grabscheit
in	APPR	in
die	ART	die
Ecke	NN	Ecke
,	$,	,
wischte	VVFIN	wischen
den	ART	die
Schweiß	NN	Schweiß
von	APPR	von
der	ART	die
Stirne	NN	Stirn
und	KON	und
setzte	VVFIN	setzen
sich	PRF	sich
an	APPR	an
den	ART	die
Tisch	NN	Tisch
,	$,	,
wo	PWAV	wo
schon	ADV	schon
ein	ART	eine
mäßiges	ADJA	mäßig
Abendessen	NN	Abendessen
bereitet	ADJD	bereitet
stand	VVFIN	stehen
.	$.	.
Sein	PPOSAT	sein
Vater	NN	Vater
Konrad	NE	Konrad
bemerkte	VVFIN	bemerken
bald	ADV	bald
,	$,	,
daß	KOUS	dass
dem	ART	die
Sohne	NN	Sohn
etwas	PIAT	etwas
Wichtigeres	NN	Wichtigere
am	APPRART	an+die
Herzen	NN	Herz
liege	VVFIN	liegen
,	$,	,
als	KOUS	als
die	ART	die
Last	NN	Last
des	ART	die
Tages	NN	Tag
,	$,	,
und	KON	und
munterte	VVFIN	muntern
ihn	PPER	er
deshalb	PAV	deshalb
auf	PTKVZ	auf
,	$,	,
seine	PPOSAT	sein
Abendkost	NN	Abendkost
mit	APPR	mit
frohem	ADJA	froh
Muthe	NN	Muthe
zu	PTKZU	zu
verzehren	VVINF	verzehren
.	$.	.
Unterdessen	ADV	unterdessen
war	VAFIN	sein
auch	ADV	auch
Bernhard	NE	Bernhard
,	$,	,
der	ART	die
ältere	ADJA	alt
Bruder	NN	Bruder
angekommen	VVPP	ankommen
.	$.	.
Sobald	KOUS	sobald
sie	PPER	sie
mit	APPR	mit
einander	PRF	einander
ihr	PPOSAT	ihr
Dankgebet	NN	Dankgebet
gesprochen	VVPP	sprechen
hatten	VAFIN	haben
,	$,	,
wollte	VMFIN	wollen
der	ART	die
Vater	NN	Vater
dem	ART	die
Sohne	NN	Sohn
das	ART	die
Geheimniß	NN	Geheimniß
entlocken	VVINF	entlocken
,	$,	,
und	KON	und
sprach	VVFIN	sprechen
:	$.	:
Fritz	NE	Fritz
!	$.	!
vertreibe	VVFIN	vertreiben
deine	PPOSAT	dein
Grillen	NN	Grille|Grillen
.	$.	.
