Gemeinnützige	ADJA	gemeinnützig
Mittheilungen	NN	Mittheilungen
.	$.	.
Drehkrankheit	NN	Drehkrankheit
der	ART	die
Schaafe	NN	Schaafe
.	$.	.
Ein	ART	eine
Schaͤfer	NN	Schaͤfer
soll	VMFIN	sollen
–	$(	-
nach	APPR	nach
einer	ART	eine
Mittheilung	NN	Mittheilung
in	APPR	in
der	ART	die
Ceres	NE	Ceres
–	$(	-
seinem	PPOSAT	sein
Herrn	NN	Herr
seit	APPR	seit
vier	CARD	vier
Jahren	NN	Jahr
schon	ADV	schon
in	APPR	in
der	ART	die
Lammzeit	NN	Lammzeit
vorausgesagt	VVPP	voraussagen
haben	VAINF	haben
,	$,	,
der	ART	die
wievielte	ADJA	wievielte
Theil	NN	Theil
der	ART	die
Laͤmmer	NN	Laͤmmer
Dreher	NE	Dreher
werden	VAFIN	werden
wuͤrde	NN	wuͤrde
,	$,	,
und	KON	und
diese	PDAT	dies
Voraussagung	NN	Voraussagung
bisher	ADV	bisher
genau	ADJD	genau
eingetroffen	VVPP	eintreffen
sein	VAINF	sein
.	$.	.
Nach	APPR	nach
dieses	PDAT	dies
Schaͤfers	NN	Schaͤfers
Ausdruck	NN	Ausdruck
werden	VAFIN	werden
solche	PIAT	solche
Laͤmmer	NN	Laͤmmer
schon	ADV	schon
dumm	ADJD	dumm
geboren	VVPP	gebären
,	$,	,
welches	PRELS	welche
er	PPER	er
daran	PAV	daran
erkennt	VVFIN	erkennen
,	$,	,
daß	KOUS	dass
sie	PPER	sie
die	ART	die
Muͤtter	NN	Muͤtter
nicht	PTKNEG	nicht
annehmen	VVINF	annehmen
wollen	VMFIN	wollen
,	$,	,
und	KON	und
nur	ADV	nur
mit	APPR	mit
Muͤhe	NN	Muͤhe
dahin	PAV	dahin
zu	PTKZU	zu
bringen	VVINF	bringen
sind	VAFIN	sein
,	$,	,
die	ART	die
erste	ADJA	erst
Nahrungsquelle	NN	Nahrungsquelle
zu	PTKZU	zu
finden	VVINF	finden
.	$.	.
Wirklich	ADJD	wirklich
hat	VAFIN	haben
auch	ADV	auch
derselbe	PDAT	derselb
Schaͤfereibesitzer	NN	Schaͤfereibesitzer
bei	APPR	bei
der	ART	die
Section	NN	Section
solcher	PIS	solche
,	$,	,
halb	ADJD	halb
nach	APPR	nach
der	ART	die
Geburt	NN	Geburt
gestorbener	ADJA	gestorben
Laͤmmer	NN	Laͤmmer
schon	ADV	schon
mehrere	PIAT	mehrere
Blaͤschen	NN	Blaͤschen
an	APPR	an
der	ART	die
Gehirnsubstanz	NN	Gehirnsubstanz
gefunden	VVPP	finden
,	$,	,
auch	ADV	auch
bemerkt	VVPP	bemerken
,	$,	,
daß	KOUS	dass
manche	PIAT	manche
Laͤmmer	NN	Laͤmmer
schon	ADV	schon
fruͤhzeitig	ADJD	fruͤhzeitig
Symptome	NN	Symptom
der	ART	die
Drehkrankheit	NN	Drehkrankheit
zeigen	VVFIN	zeigen
,	$,	,
oft	ADV	oft
ohne	APPR	ohne
weiteres	ADJA	weit
Zuthun	NN	Zuthun
wieder	ADV	wieder
genesen	VVPP	genesen
,	$,	,
spaͤter	NN	spaͤter
aber	ADV	aber
als	KOKOM	als
Jaͤhrlinge	NN	Jaͤhrlinge
in	APPR	in
dieselbe	PDAT	dieselb
Krankheit	NN	Krankheit
ohne	APPR	ohne
Genesung	NN	Genesung
zuruͤckfallen	VVFIN	zuruͤckfallen
.	$.	.
