Bayern	NE	Bayern
.	$.	.
Kempten	NE	Kempten
,	$,	,
30	ADJA	@card@
Januar	NN	Januar
.	$.	.
Dem	ART	die
Vernehmen	NN	Vernehmen
nach	APPO	nach
sind	VAFIN	sein
die	ART	die
Prozeßakten	NN	Prozeßakte
in	APPR	in
der	ART	die
Untersuchung	NN	Untersuchung
gegen	APPR	gegen
meinen	PPOSAT	mein
Freund	NN	Freund
Dannheimer	NE	Dannheimer
und	KON	und
seinen	PPOSAT	sein
Commis	NN	Commis
Fischer	NE	Fischer
nach	APPR	nach
Neuburg	NN	Neuburg
gewandert	VVPP	wandern
.	$.	.
Inzwischen	ADV	inzwischen
reiben	VVFIN	reiben
unsere	PPOSAT	unser
„	$(	„
Gutgesinnten	ADJA	gutgesinnt
”	NN	”
vergnügt	VVFIN	vergnügen
die	ART	die
Hände	NN	Hand
,	$,	,
und	KON	und
schämen	VVFIN	schämen
sich	PRF	sich
nicht	PTKNEG	nicht
,	$,	,
gegen	APPR	gegen
die	ART	die
Verhafteten	NN	Verhaftete
fortwährend	ADJD	fortwährend
Verdächtigungen	NN	Verdächtigung
auszustreuen	VVIZU	ausstreuen
.	$.	.
Ich	PPER	ich
bin	VAFIN	sein
jedoch	ADV	jedoch
im	APPRART	in+die
Stande	NN	Stand
,	$,	,
nicht	PTKNEG	nicht
nur	ADV	nur
als	KOKOM	als
Mann	NN	Mann
,	$,	,
sondern	KON	sondern
auch	ADV	auch
als	KOKOM	als
Jurist	NN	Jurist
die	ART	die
bestimmteste	ADJA	bestimmteste
Versicherung	NN	Versicherung
zu	PTKZU	zu
geben	VVINF	geben
,	$,	,
daß	KOUS	dass
die	ART	die
zwei	CARD	zwei
Männer	NN	Mann
nichts	PIS	nichts
verbrochen	VVPP	verbrechen
haben	VAFIN	haben
,	$,	,
und	KON	und
daß	KOUS	dass
beide	PIS	beide
unschuldig	ADJD	unschuldig
im	APPRART	in+die
Kerker	NN	Kerker
schmachten	VVINF	schmachten
.	$.	.
Doch	KON	doch
zur	APPRART	zu+die
Zeit	NN	Zeit
gebieten	VVFIN	gebieten
mir	PPER	ich
die	ART	die
Umstände	NN	Umstand
noch	ADV	noch
zu	PTKZU	zu
schweigen	VVINF	schweigen
;	$.	;
ist	VAFIN	sein
aber	ADV	aber
der	ART	die
Moment	NN	Moment
zum	APPRART	zu+die
Reden	NN	Rede|Reden
gekommen	VVPP	kommen
,	$,	,
so	ADV	so
soll	VMFIN	sollen
man	PIS	man
mich	PRF	ich
nicht	PTKNEG	nicht
stumm	ADJD	stumm
finden	VVINF	finden
.	$.	.
Waibel	ADJD	Waibel
.	$.	.
