Breslau	NE	Breslau
vom	APPRART	von+die
19	CARD	@card@
.	$.	.
Januar	NN	Januar
.	$.	.
Gestern	ADV	gestern
war	VAFIN	sein
zur	APPRART	zu+die
Feier	NN	Feier
des	ART	die
Kroͤnungsfestes	NN	Kroͤnungsfestes
große	ADJA	groß
militaͤrische	ADJA	militaͤrische
Parade	NN	Parade
.	$.	.
Abends	ADV	abends
gaben	VVFIN	geben
Seine	NE	Seine
Excellenz	NN	Excellenz
der	ART	die
kommandirende	ADJA	kommandirende
General	NN	General
Graf	NE	Graf
von	APPR	von
Ziethen	NN	Ziethen
Assemblée	NE	Assemblée
dansante	VVFIN	dansante
.	$.	.
Im	APPRART	in+die
Theater	NN	Theater
wurde	VAFIN	werden
ein	ART	eine
von	APPR	von
Hrn.	NN	Hrn.
Geisheim	NN	Geisheim
verfaßter	ADJA	verfasst
die	ART	die
Feier	NN	Feier
des	ART	die
Tages	NN	Tag
bezeichnender	ADJA	bezeichnend
Prolog	NN	Prolog
von	APPR	von
Hrn.	NN	Hrn.
Opern	NN	Oper
=	$(	=
Regisseur	NN	Regisseur
Mosevius	NE	Mosevius
gesprochen	VVPP	sprechen
.	$.	.
