Inland	NN	Inland
.	$.	.
Breslau	NE	Breslau
,	$,	,
vom	APPRART	von+die
30sten	ADJA	30sten
Januar	NN	Januar
.	$.	.
Den	ART	die
heutigen	ADJA	heutig
Tag	NN	Tag
,	$,	,
an	APPR	an
dem	PRELS	die
das	ART	die
Haupt	NN	Haupt
der	ART	die
Preußischen	ADJA	preußisch
Justiz	NN	Justiz
,	$,	,
der	ART	die
wirkliche	ADJA	wirklich
Geheime	NN	Geheime
Staats	NN	Staat
=	$(	=
und	KON	und
Justiz	NN	Justiz
=	$(	=
Minister	NN	Minister
von	APPR	von
Kircheisen	NN	Kircheisen
,	$,	,
vor	APPR	vor
funfzig	CARD	funfzig
Jahren	NN	Jahr
seine	PPOSAT	sein
juristische	ADJA	juristisch
Wirksamkeit	NN	Wirksamkeit
als	KOKOM	als
Referendarius	NN	Referendarius
des	ART	die
Koͤnigl	NN	Koͤnigl
.	$.	.
Kammer	NN	Kammer
=	$(	=
Gerichts	NN	Gericht
begann	VVFIN	beginnen
,	$,	,
feierten	VVFIN	feiern
die	ART	die
hiesigen	ADJA	hiesig
Justiz	NN	Justiz
=	$(	=
Beamten	NN	Beamter
,	$,	,
bei	APPR	bei
einem	ART	eine
froͤhlichen	ADJA	froͤhlichen
Mittags	NN	Mittag
=	$(	=
Male	NN	Mal
,	$,	,
in	APPR	in
dem	ART	die
geschmackvollen	ADJA	geschmackvoll
Logen	NN	Loge
=	$(	=
Saale	NE	Saale
Friedrich	NE	Friedrich
zum	APPRART	zu+die
goldenen	ADJA	golden
Scepter	NN	Scepter
.	$.	.
In	APPR	in
inniger	ADJA	innig
Verehrung	NN	Verehrung
des	ART	die
Jubelgreises	NN	Jubelgreises
und	KON	und
in	APPR	in
schoͤner	ADJA	schoͤner
Eintracht	NN	Eintracht
,	$,	,
hatten	VAFIN	haben
sich	PRF	sich
ihnen	PPER	sie
mehrere	PIAT	mehrere
Mitglieder	NN	Mitglied
der	ART	die
hiesigen	ADJA	hiesig
Regierung	NN	Regierung
angeschlossen	VVPP	anschließen
;	$.	;
und	KON	und
als	KOKOM	als
erbethene	ADJA	erbethene
Gaͤste	NN	Gaͤste
verschoͤnerten	VVFIN	verschoͤnerten
das	ART	die
heitere	ADJA	heiter
Fest	NN	Fest
des	ART	die
in	APPR	in
Schlesien	NE	Schlesien
kommandirenden	ADJA	kommandirenden
Generals	NN	General
Herrn	NN	Herr
Grafen	NN	Graf
v.	APPR	von
Ziethen	NN	Ziethen
Excellenz	NN	Excellenz
,	$,	,
so	ADV	so
wie	KOKOM	wie
die	ART	die
Ersten	NN	Erste
aller	PIAT	alle
hiesigen	ADJA	hiesig
Behoͤrden	NN	Behoͤrden
.	$.	.
Laut	ADJD	laut
und	KON	und
innig	ADJD	innig
ertoͤnten	VVFIN	ertoͤnten
die	ART	die
Wuͤnsche	NN	Wuͤnsche
für	APPR	für
den	ART	die
hochverehrten	ADJA	hochverehrt
Jubelgreis	NN	Jubelgreis
,	$,	,
der	PRELS	die
Seine	NE	Seine
funfzigjaͤhrige	ADJA	funfzigjaͤhrige
Bahn	NN	Bahn
,	$,	,
wie	KOUS	wie
eines	PIS	eine
der	ART	die
bei	APPR	bei
dem	ART	die
Feste	NN	Fest
gesungenen	ADJA	gesungen
Lieder	NN	Lied
spricht	VVFIN	sprechen
:	$.	:
„	$(	„
ging	VVFIN	gehen
...	$.	...
.	$.	.
.	$.	.
ohne	APPR	ohne
Wanken	NN	Wanken
,	$,	,
Wie	KOUS	wie
ein	ART	eine
Heros	NN	Heros
wunderbar	ADJD	wunderbar
;	$.	;
In	APPR	in
dem	ART	die
Kreise	NN	Kreis
der	ART	die
Gedanken	NN	Gedanke
,	$,	,
Maͤchtig	ADJD	Maͤchtig
thronend	ADJD	thronend
,	$,	,
ruhig	ADJD	ruhig
klar	ADJD	klar
;	$.	;
Kuͤhn	NN	Kuͤhn
den	ART	die
Schlangenkreis	NN	Schlangenkreis
durchbrechend	ADJD	durchbrechend
,	$,	,
Der	PRELS	die
vom	APPRART	von+die
Mark	NN	Mark
der	ART	die
Guͤte	NN	Guͤte
zehrt	VVFIN	zehren
,	$,	,
Die	ART	die
gekraͤnkte	ADJA	gekraͤnkte
Unschuld	NN	Unschuld
raͤchend	ADJD	raͤchend
Und	KON	und
beschuͤtzend	ADJD	beschuͤtzend
ihren	PPOSAT	ihr
Heer	NN	Heer
?	$.	?
.	$.	.
Moͤge	NN	Moͤge
Er	PPER	er
lange	ADV	lange
noch	ADV	noch
so	ADV	so
uͤber	NN	uͤber
uns	PRF	wir
walten	VVINF	walten
!	$.	!
—	$,	—
