Speyer	NE	Speyer
.	$.	.
Die	ART	die
Vorzüglichsten	ADJA	vorzüglich
der	ART	die
40	ADJA	@card@
Pyrenäischen	NN	Pyrenäischen
Bergsänger	NN	Bergsänger
haben	VAFIN	haben
am	APPRART	an+die
letzten	ADJA	letzt
Samstage	NN	Samstag
,	$,	,
im	APPRART	in+die
Lyceumssaale	NN	Lyceumssaale
,	$,	,
das	ART	die
angekündigte	ADJA	angekündigt
Concert	NN	Concert
gegeben	VVPP	geben
,	$,	,
in	APPR	in
Gegenwart	NN	Gegenwart
einer	ART	eine
glänzenden	ADJA	glänzend
und	KON	und
zahlreichen	ADJA	zahlreich
Versammlung	NN	Versammlung
,	$,	,
aus	APPR	aus
den	ART	die
auserwähltesten	ADJA	auserwähltesten
Bewohnern	NN	Bewohner
der	ART	die
Stadt	NN	Stadt
und	KON	und
Umgegend	NN	Umgegend
bestehend	ADJD	bestehend
.	$.	.
Nach	APPR	nach
allen	PIAT	alle
Stücken	NN	Stück
erfolgte	VVFIN	erfolgen
stürmischer	ADJA	stürmisch
Applaus	NN	Applaus
,	$,	,
besonders	ADV	besonders
auf	APPR	auf
„	$(	„
la	FM	la
bagnèrre	NE	bagnèrre
des	ART	die
ménéstrels	NN	ménéstrels
,	$,	,
”	NN	”
„	$(	„
das	ART	die
Pyrenäen	NN	Pyrenäen
=	$(	=
und	KON	und
das	ART	die
Toulouserlied	NN	Toulouserlied
.	$.	.
”	NN	”
Den	ART	die
folgenden	ADJA	folgend
Tag	NN	Tag
fand	VVFIN	finden
die	ART	die
Aufführung	NN	Aufführung
eines	ART	eine
großen	ADJA	groß
Oratoriums	NN	Oratorium
in	APPR	in
demselben	PDAT	dieselb
Saale	NN	Saal
,	$,	,
zum	APPRART	zu+die
Besten	NN	Beste
der	ART	die
Speyerer	NN	Speyerer
Armen	NN	Arm|Arme
statt	PTKVZ	statt
,	$,	,
wobei	PWAV	wobei
sich	PRF	sich
die	ART	die
berühmten	ADJA	berühmt
Sänger	NN	Sänger
,	$,	,
wie	KOKOM	wie
Tags	NN	Tag
zuvor	ADV	zuvor
beständig	ADJD	beständig
im	APPRART	in+die
Gleichgewichte	NN	Gleichgewicht
ihres	PPOSAT	ihr
hoben	VVFIN	heben
Ruhmes	NN	Ruhm
erhielten	VVFIN	erhalten
,	$,	,
und	KON	und
ihnen	PPER	sie
nochmals	ADV	nochmals
von	APPR	von
den	ART	die
zahlreich	ADJD	zahlreich
Anwesenden	NN	Anwesende
der	ART	die
gerechteste	ADJA	gerecht
Beifall	NN	Beifall
gezollt	VVPP	zollen
wurde	VAFIN	werden
,	$,	,
welche	PWAT	welche
,	$,	,
sich	PRF	sich
einem	ART	eine
guten	ADJA	gut
Werke	NN	Werk
anschließend	ADJD	anschließend
,	$,	,
den	ART	die
Pyrenäischen	NN	Pyrenäischen
Sängern	NN	Sänger
ein	ART	eine
neues	ADJA	neu
Zeichen	NN	Zeichen
ihrer	PPOSAT	ihr
lebhaften	ADJA	lebhaft
Sympathie	NN	Sympathie
kund	PTKVZ	kund
geben	VVINF	geben
wollten	VMFIN	wollen
.	$.	.
