Breslau	NE	Breslau
,	$,	,
vom	APPRART	von+die
6	CARD	@card@
.	$.	.
Mai	NE	Mai
.	$.	.
Gestern	ADV	gestern
wurde	VAFIN	werden
hier	ADV	hier
die	ART	die
Vermaͤhlung	NN	Vermaͤhlung
der	ART	die
Graͤfin	NN	Graͤfin
Josephine	NE	Josephine
von	APPR	von
Zieten	NN	Zieten
,	$,	,
einzigen	ADJA	einzig
Tochter	NN	Tochter
Seiner	PPOSAT	sein
Excellenz	NN	Excellenz
des	ART	die
kommandirenden	ADJA	kommandirenden
Herrn	NN	Herr
Generals	NN	General
,	$,	,
Grafen	NN	Graf
von	APPR	von
Zieten	NN	Zieten
,	$,	,
mit	APPR	mit
dem	ART	die
Koͤnigl	NN	Koͤnigl
.	$.	.
Kammerherrn	NN	Kammerherr
,	$,	,
Herrn	NN	Herr
Grafen	NN	Graf
von	APPR	von
Schaffgotsch	NN	Schaffgotsch
auf	APPR	auf
Maiwalde	NN	Maiwalde
,	$,	,
feierlichst	ADJD	feierlich
vollzogen	VVPP	vollziehen
.	$.	.
