Breslau	NE	Breslau
vom	APPRART	von+die
30	CARD	@card@
.	$.	.
Dec	NE	Dec
.	$.	.
Das	ART	die
Erb	VVIMP	erben
=	$(	=
Großherzoglich	ADJD	großherzoglich
Weimarsche	ADJA	Weimarsche
Ehepaar	NN	Ehepaar
traf	VVFIN	treffen
gestern	ADV	gestern
Abend	NN	Abend
nach	APPR	nach
6	CARD	@card@
Uhr	NN	Uhr
hieselbst	NN	hieselbst
ein	PTKVZ	ein
,	$,	,
trat	VVFIN	treten
im	APPRART	in+die
Regierungshause	NN	Regierungshause
ab	PTKVZ	ab
,	$,	,
beehrte	VVFIN	beehren
sodann	ADV	sodann
das	ART	die
Theater	NN	Theater
mit	APPR	mit
Seiner	PPOSAT	sein
Gegenwart	NN	Gegenwart
,	$,	,
zog	VVFIN	ziehen
nach	APPR	nach
demselben	PDAT	dieselb
mehrere	PIAT	mehrere
angesehene	ADJA	angesehen
Personen	NN	Person
zur	APPRART	zu+die
Abendtafel	NN	Abendtafel
und	KON	und
setzte	VVFIN	setzen
diesen	PDAT	dies
Morgen	NN	Morgen
um	APPR	um
1/2	CARD	@card@
8	CARD	@card@
Uhr	NN	Uhr
seine	PPOSAT	sein
Reise	NN	Reise
nach	APPR	nach
Weimar	NE	Weimar
fort	ADV	fort
um	APPR	um
daselbst	ADV	daselbst
am	APPRART	an+die
3	CARD	@card@
.	$.	.
Januar	NN	Januar
einzutreffen	VVIZU	eintreffen
.	$.	.
Wie	KOKOM	wie
man	PIS	man
sagt	VVFIN	sagen
,	$,	,
soll	VMFIN	sollen
Se	NE	se
.	$.	.
Maj	NE	Maj
.	$.	.
der	ART	die
Kaiser	NN	Kaiser
von	APPR	von
Rußland	NE	Russland
die	ART	die
Frau	NN	Frau
Erbgroßherzogin	NN	Erbgroßherzogin
eingeladen	VVPP	einladen
haben	VAFIN	haben
,	$,	,
nach	APPR	nach
einiger	PIAT	einige
Anwesenheit	NN	Anwesenheit
in	APPR	in
Weimar	NE	Weimar
,	$,	,
nach	APPR	nach
Laibach	NN	Laibach
zu	PTKZU	zu
kommen	VVINF	kommen
.	$.	.
