Vaterlaͤndische	ADJA	Vaterlaͤndische
Nachrichten	NN	Nachricht
.	$.	.
Mannheim	NE	Mannheim
,	$,	,
den	ART	die
15	CARD	@card@
.	$.	.
Aug	NE	Aug
.	$.	.
Durch	APPR	durch
die	ART	die
hoͤchste	ADJA	hoͤchste
Entschließung	NN	Entschließung
Sr.	NE	Sr.
koͤnigl	NE	koͤnigl
.	$.	.
Hoheit	NN	Hoheit
,	$,	,
des	ART	die
Großherzogs	NN	Großherzog
v.	APPR	von
16	CARD	@card@
.	$.	.
Juni	NN	Juni
d.	ART	d.
J.	NE	J.
Regbl	NE	Regbl
.	$.	.
Nr.	NN	Nr.
15	CARD	@card@
.	$.	.
v.	APPR	von
25	CARD	@card@
.	$.	.
v.	APPR	von
M.	NE	M.
wurde	VAFIN	werden
dem	ART	die
Oberbuͤrgermeister	NN	Oberbuͤrgermeister
Moͤhl	NN	Moͤhl
in	APPR	in
Mannheim	NE	Mannheim
,	$,	,
wegen	APPR	wegen
seines	PPOSAT	sein
ausgezeichneten	ADJA	ausgezeichnet
Benehmens	NN	Benehmen
bey	NE	Bey
der	ART	die
im	APPRART	in+die
vorigen	ADJA	vorig
Spaͤtjahre	NN	Spaͤtjahre
statt	APPR	statt
gehabten	ADJA	gehabt
Ueberschwemmung	NN	Ueberschwemmung
und	KON	und
wegen	APPR	wegen
seiner	PPOSAT	sein
musterhaften	ADJA	musterhaft
Amtsverwaltung	NN	Amtsverwaltung
die	ART	die
große	ADJA	groß
goldene	ADJA	golden
Civil	NN	Civil
=	$(	=
Verdienst	NN	Verdienst
=	$(	=
Medaille	NN	Medaille
verliehen	VVPP	verleihen
.	$.	.
Bey	NE	Bey
dieser	PDAT	dies
Veranlassung	NN	Veranlassung
erhielt	VVFIN	erhalten
Ober	NN	Ober
=	$(	=
Buͤrgermeister	NN	Buͤrgermeister
Moͤhl	NN	Moͤhl
das	ART	die
nachstehende	ADJA	nachstehend
Allerhoͤchste	NN	Allerhoͤchste
Handschreiben	NN	Handschreiben
Sr.	NE	Sr.
koͤn	VVFIN	koͤn
.	$.	.
Hoh	VVFIN	Hoh
.	$.	.
des	ART	die
Großherzogs	NN	Großherzog
:	$.	:
Mein	PPOSAT	mein
lieber	ADJA	lieb
Oberbuͤrgermeister	NN	Oberbuͤrgermeister
Moͤ	NE	Moͤ
hl.	ADJA	hl.
Die	ART	die
Redlichkeit	NN	Redlichkeit
Ihrer	PPOSAT	ihr
Gesinnungen	NN	Gesinnung
,	$,	,
und	KON	und
Ihre	PPOSAT	ihr
Verdienste	NN	Verdienst
um	APPR	um
das	ART	die
allgemeine	ADJA	allgemein
Beste	NN	Beste
sind	VAFIN	sein
Mir	PPER	ich
nicht	PTKNEG	nicht
unbekannt	ADJD	unbekannt
geblieben	VVPP	bleiben
.	$.	.
Zum	APPRART	zu+die
Beweis	NN	Beweis
,	$,	,
daß	KOUS	dass
Ich	NN	Ich
ein	ART	eine
solches	PIAT	solche
Bestreben	NN	Bestreben
stets	ADV	stets
ehre	VVFIN	ehren
und	KON	und
schaͤtze	NN	schaͤtze
,	$,	,
habe	VAFIN	haben
ich	PPER	ich
gerne	ADV	gerne
Ihnen	PPER	Sie
ein	ART	eine
oͤffentliches	ADJA	oͤffentliches
Merkmal	NN	Merkmal
Meiner	PPOSAT	mein
Zufriedenheit	NN	Zufriedenheit
verliehen	VVPP	verleihen
.	$.	.
–	$(	-
Fahren	NN	Fahren
Sie	PPER	Sie
in	APPR	in
Ihren	PPOSAT	ihr
loͤblichen	ADJA	loͤblichen
Bemuͤhungen	NN	Bemuͤhungen
fort	PTKVZ	fort
,	$,	,
und	KON	und
seyn	NE	seyn
Sie	PPER	Sie
versichert	VVPP	versichern
,	$,	,
daß	KOUS	dass
Ich	NN	Ich
auch	ADV	auch
fernerhin	ADV	fernerhin
Ihnen	PPER	Sie
die	ART	die
wohlwollenden	ADJA	wohlwollend
Besinnungen	NN	Besinnungen
bethaͤtigen	VVINF	bethaͤtigen
werde	VAFIN	werden
,	$,	,
womit	PWAV	womit
Ich	NN	Ich
bin	VAFIN	sein
Carlsruhe	NE	Carlsruhe
,	$,	,
den	ART	die
3	CARD	@card@
.	$.	.
August	NN	August
1825	CARD	@card@
.	$.	.
Ihr	PPOSAT	ihr
wohlgeneigter	ADJA	wohlgeneigter
Ludwig	NE	Ludwig
.	$.	.
Wer	PWS	wer
von	APPR	von
uns	PPER	wir
allen	PIAT	alle
wuͤrde	NN	wuͤrde
nicht	PTKNEG	nicht
mit	APPR	mit
treuer	ADJA	treu
Anhaͤnglichkeit	NN	Anhaͤnglichkeit
und	KON	und
mit	APPR	mit
Stolz	NN	Stolz
einem	ART	eine
Fuͤrsten	NN	Fuͤrsten
dienen	VVFIN	dienen
,	$,	,
dessen	PRELAT	die
umfassendem	ADJA	umfassend
Blick	NN	Blick
kein	PIAT	keine
Verdienst	NN	Verdienst
entgeht	VVFIN	entgehen
,	$,	,
und	KON	und
der	PRELS	die
dasselbe	PDS	dasselbe
so	ADV	so
großherzig	ADJD	großherzig
zu	PTKZU	zu
belohnen	VVINF	belohnen
weiß	VVFIN	wissen
!	$.	!
