—	$,	—
Der	PRELS	die
Social	ADJD	Social
=	$(	=
Verein	NN	Verein
warnt	VVFIN	warnen
vor	APPR	vor
dem	ART	die
sogenannten	ADJA	sogenannt
demokratischen	ADJA	demokratisch
Bankett	NN	Bankett
,	$,	,
das	PRELS	die
für	APPR	für
Sonnabend	NN	Sonnabend
im	APPRART	in+die
Kroll	NE	Kroll
'	$(	'
schen	ADJA	schen
Garten	NN	Garten
angekündigt	VVPP	ankündigen
ist	VAFIN	sein
,	$,	,
indem	KOUS	indem
er	PPER	er
dasselbe	PDS	dasselbe
für	APPR	für
eine	ART	eine
bloße	ADJA	bloß
Privat	ADJD	privat
=	$(	=
Geldspeculation	NN	Geldspeculation
hält	VVFIN	halten
.	$.	.
—	$,	—
Nachdem	KOUS	nachdem
wir	PPER	wir
in	APPR	in
der	ART	die
jüngsten	ADJA	jung
Zeit	NN	Zeit
viel	ADV	viel
von	APPR	von
Festlichkeiten	NN	Festlichkeit
innerhalb	APPR	innerhalb
der	ART	die
einzelnen	ADJA	einzeln
Compagnien	NN	Compagnien
der	ART	die
Bürgerwehr	NN	Bürgerwehr
zu	PTKZU	zu
berichten	VVINF	berichten
hatten	VAFIN	haben
,	$,	,
ist	VAFIN	sein
heute	ADV	heute
mitzutheilen	VVIZU	mitzutheilen
,	$,	,
daß	KOUS	dass
am	APPRART	an+die
21	CARD	@card@
.	$.	.
d.	ART	d.
M.	NE	M.
ein	ART	eine
großes	ADJA	groß
gemeinschaftliches	ADJA	gemeinschaftlich
Abendessen	NN	Abendessen
von	APPR	von
Bürgerwehrmännern	NN	Bürgerwehrmännern
aller	PIAT	alle
Compagnieen	NN	Compagnieen
zu	APPR	zu
Ehren	NN	Ehre|Ehren
des	ART	die
Commandeurs	NN	Commandeurs
Rimpler	NN	Rimpler
im	APPRART	in+die
Kroll	NE	Kroll
'	$(	'
schen	ADJA	schen
Lokale	NN	Lokal
stattfinden	VVINF	stattfinden
soll	VMFIN	sollen
.	$.	.
Es	PPER	es
haben	VAFIN	haben
sich	PRF	sich
bereits	ADV	bereits
zahlreiche	ADJA	zahlreich
Theilnehmer	NN	Theilnehmer
dazu	PAV	dazu
gemeldet	VVPP	melden
.	$.	.
—	$,	—
Das	ART	die
große	ADJA	groß
Concert	NN	Concert
,	$,	,
welches	PRELS	welche
der	ART	die
Verein	NN	Verein
der	ART	die
Pommern	NN	Pommer
für	APPR	für
Recht	NN	Recht
und	KON	und
Wahrheit	NN	Wahrheit
zum	APPRART	zu+die
Besten	NN	Beste
der	ART	die
Erbauung	NN	Erbauung
einer	ART	eine
preußischen	ADJA	preußisch
Fregatte	NN	Fregatte
,	$,	,
am	APPRART	an+die
Mittwoch	NN	Mittwoch
Nachmittag	NN	Nachmittag
im	APPRART	in+die
Thiergarten	NN	Thiergarten
veranlaßt	VVPP	veranlassen
hatte	VAFIN	haben
,	$,	,
hat	VAFIN	haben
unter	APPR	unter
ungeheurem	ADJA	ungeheuer
Volks	NN	Volk
=	$(	=
Andrang	NN	Andrang
beim	APPRART	bei+die
schönsten	ADJA	schön
Wetter	NN	Wetter
statt	PTKVZ	statt
gefunden	VVPP	finden
.	$.	.
Die	ART	die
Linden	NN	Linde
bildeten	VVFIN	bilden
einen	ART	eine
dichten	ADJA	dicht
Menschenstrom	NN	Menschenstrom
.	$.	.
Am	APPRART	an+die
Kroll'schen	ADJA	Kroll'schen
Etablissement	NN	Etablissement
war	VAFIN	sein
die	ART	die
Masse	NN	Masse
so	ADV	so
gedrängt	VVPP	drängen
,	$,	,
daß	KOUS	dass
man	PIS	man
sich	PRF	sich
mühsam	ADJD	mühsam
bis	KON	bis
zu	APPR	zu
den	ART	die
Zelten	NN	Zelt|Zelten
durchkämpfte	VVFIN	durchkämpfen
.	$.	.
Hier	ADV	hier
erscholl	VVFIN	erschallen
inmitten	APPR	inmitten
einer	ART	eine
unabsehbaren	ADJA	unabsehbar
Menge	NN	Menge
aus	APPR	aus
dichter	ADJA	dicht
Staubwolke	NN	Staubwolke
heraus	ADV	heraus
die	ART	die
Musik	NN	Musik
.	$.	.
Eben	ADV	eben
so	ADV	so
am	APPRART	an+die
nächsten	ADJA	nah
Stern	NN	Stern
bei	APPR	bei
Bellevue	NN	Bellevue
,	$,	,
in	APPR	in
der	ART	die
großen	ADJA	groß
Hofjäger	NN	Hofjäger
=	$(	=
Allee	NN	Allee
,	$,	,
wo	PWAV	wo
sich	PRF	sich
Wagen	NN	Wagen
und	KON	und
Menschen	NN	Mensch
so	ADV	so
ineinander	ADV	ineinander
drängten	VVFIN	drängen
,	$,	,
daß	KOUS	dass
sie	PPER	sie
sich	PRF	sich
kaum	ADV	kaum
vorwärts	ADV	vorwärts
bewegen	VVINF	bewegen
konnten	VMFIN	können
,	$,	,
und	KON	und
an	APPR	an
allen	PIAT	alle
übrigen	ADJA	übrig
Punkten	NN	Punkt
wo	PWAV	wo
Musikcorps	NN	Musikcorps
aufgestellt	VVPP	aufstellen
waren	VAFIN	sein
.	$.	.
Einen	ART	eine
ferneren	ADJA	fern
Bericht	NN	Bericht
müssen	VMFIN	müssen
wir	PPER	wir
uns	PRF	wir
vorbehalten	VVPP	vorbehalten
.	$.	.
—	$,	—
Durch	APPR	durch
das	PRELS	die
am	APPRART	an+die
15	CARD	@card@
.	$.	.
d.	ART	d.
M.	NE	M.
Abends	NN	Abend
auf	APPR	auf
dem	ART	die
Grundstück	NN	Grundstück
des	ART	die
Seidenfärbereibesitzers	NN	Seidenfärbereibesitzers
Hrn.	NN	Hrn.
Spindler	NN	Spindler
,	$,	,
Wallstraße	NN	Wallstraße
No	NN	No
.	$.	.
12	CARD	@card@
.	$.	.
,	$,	,
stattgehabte	ADJA	stattgehabt
Zerspringen	NN	Zerspringen
eines	ART	eine
Dampfkessels	NN	Dampfkessel
,	$,	,
ward	VVFIN	werd
ein	ART	eine
dort	ADV	dort
beschäftigter	ADJA	beschäftigt
Arbeiter	NN	Arbeiter
am	APPRART	an+die
ganzen	ADJA	ganz
Leibe	NN	Leib
so	ADV	so
bedeutend	ADJD	bedeutend
verbrannt	VVPP	verbrennen
,	$,	,
daß	KOUS	dass
er	PPER	er
nach	APPR	nach
einigen	PIAT	einige
Stunden	NN	Stunde|Stunden
verschied	VVFIN	verscheiden
.	$.	.
—	$,	—
Auch	ADV	auch
einige	PIAT	einige
Militair	NN	Militair
=P	NN	=P
ersonen	NN	ersonen
sind	VAFIN	sein
jetzt	ADV	jetzt
hier	ADV	hier
von	APPR	von
der	ART	die
Cholera	NN	Cholera
befallen	VVPP	befallen
worden	VAPP	werden
.	$.	.
—	$,	—
Die	ART	die
Cholera	NN	Cholera
macht	VVFIN	machen
verhältnißmäßig	ADJD	verhältnißmäßig
langsame	ADJA	langsam
Fortschritte	NN	Fortschritt
.	$.	.
Bis	KON	bis
gestern	ADV	gestern
waren	VAFIN	sein
50	CARD	@card@
Personen	NN	Person
daran	PAV	daran
erkrankt	VVPP	erkranken
,	$,	,
von	APPR	von
denen	PRELS	die
4	CARD	@card@
genesen	VVPP	genesen
,	$,	,
40	CARD	@card@
starben	VVFIN	sterben
und	KON	und
6	CARD	@card@
in	APPR	in
Behandlung	NN	Behandlung
blieben	VVINF	bleiben
.	$.	.
