(	$(	(
So	ADV	so
stirbt	VVFIN	sterben
nur	ADV	nur
ein	ART	eine
Franzose	NN	Franzose
!	$.	!
)	$(	)
In	APPR	in
London	NE	London
fiel	VVFIN	fallen
neulich	ADV	neulich
von	APPR	von
einem	ART	eine
Dörrboden	NN	Dörrboden
ein	ART	eine
arbeitender	ADJA	arbeitend
Franzose	NN	Franzose
durch	APPR	durch
einen	ART	eine
Schornstein	NN	Schornstein
(	$(	(
von	APPR	von
drei	CARD	drei
Treppen	NN	Treppe
Höhe	NN	Höhe
)	$(	)
in	APPR	in
eine	ART	eine
Küche	NN	Küche
auf	APPR	auf
den	ART	die
Herd	NN	Herd
,	$,	,
an	APPR	an
welchem	PRELS	welche
drei	CARD	drei
junge	ADJA	jung
Mädchen	NN	Mädchen
standen	VVFIN	stehen
.	$.	.
Noch	ADV	noch
im	APPRART	in+die
Fallen	NN	Falle
schrie	VVFIN	schreien
der	ART	die
Franzose	NN	Franzose
:	$.	:
„	$(	„
Pardon	NN	Pardon
,	$,	,
mes	VVFIN	mes
dames	ADJD	dames
!	$.	!
“	$(	“
plumpte	ADJD	plumpte
hin	PTKVZ	hin
und	KON	und
war	VAFIN	sein
todt	ADJD	todt
.	$.	.
So	ADV	so
galant	ADJD	galant
stirbt	VVFIN	sterben
nur	ADV	nur
ein	ART	eine
Franzose	NN	Franzose
.	$.	.
