Herzogthum	NE	Herzogthum
Salzburg	NE	Salzburg
.	$.	.
19	CARD	@card@
.	$.	.
August	NE	August
.	$.	.
Gestern	ADV	gestern
Abends	NN	Abend
9	CARD	@card@
Uhr	NN	Uhr
trafen	VVFIN	treffen
Se	NE	se
.	$.	.
königl	NE	königl
.	$.	.
Hoheit	NN	Hoheit
der	ART	die
Kronprinz	NN	Kronprinz
von	APPR	von
Bayern	NE	Bayern
,	$,	,
unter	APPR	unter
dem	ART	die
Incognito	NN	Incognito
eines	ART	eine
Grafen	NN	Graf
von	APPR	von
Werdenfels	NN	Werdenfels
hier	ADV	hier
ein	PTKVZ	ein
,	$,	,
und	KON	und
stiegen	VVFIN	steigen
im	APPRART	in+die
Gasthofe	NN	Gasthofe
zum	APPRART	zu+die
goldenen	ADJA	golden
Schiffe	NN	Schiff
ab	PTKVZ	ab
,	$,	,
wo	PWAV	wo
Höchstsie	NN	Höchstsie
von	APPR	von
den	ART	die
Civil	NN	Civil
=	$(	=
und	KON	und
Militär	NN	Militär
=	$(	=
Autoritäten	NN	Autorität
feierlich	ADJD	feierlich
empfangen	VVPP	empfangen
wurden	VAFIN	werden
.	$.	.
Vor	APPR	vor
dem	ART	die
Absteigquartier	NN	Absteigquartier
war	VAFIN	sein
eine	ART	eine
Compagnie	NN	Compagnie
des	ART	die
löbl	NE	löbl
.	$.	.
k.	NN	k.
k.	NN	k.
Inf.	NN	Inf.
Reg.	NN	Reg.
Baron	NN	Baron
Fürstenwärther	NN	Fürstenwärther
mit	APPR	mit
fliegender	ADJA	fliegend
Fahne	NN	Fahne
und	KON	und
klingendem	ADJA	klingend
Spiele	NN	Spiel
en	FM	en
parade	NN	Parade
als	KOKOM	als
Ehrenswache	NN	Ehrenswache
aufgestellt	VVPP	aufstellen
,	$,	,
und	KON	und
die	ART	die
Kapelle	NN	Kapelle
des	ART	die
vorgenannten	ADJA	vorgenannt
Infanterie	NN	Infanterie
=	$(	=
Regiments	NN	Regiment
brachte	VVFIN	bringen
Sr.	NE	Sr.
königl	NE	königl
.	$.	.
Hoheit	NN	Hoheit
eine	ART	eine
Nachtmusik	NN	Nachtmusik
dar	PTKVZ	dar
.	$.	.
