Vermischtes	NN	Vermischte
Jn	NE	Jn
der	ART	die
Nacht	NN	Nacht
vom	APPRART	von+die
22	CARD	@card@
.	$.	.
auf	APPR	auf
den	ART	die
23	CARD	@card@
.	$.	.
December	ADJD	December
v.	APPR	von
J.	NE	J.
Morgens	NN	Morgen
zwischen	APPR	zwischen
3	CARD	@card@
und	KON	und
4	CARD	@card@
Uhr	NN	Uhr
,	$,	,
da	KOUS	da
eben	ADV	eben
einer	PIS	eine
der	ART	die
heftigsten	ADJA	heftig
Stuͤrme	NN	Stuͤrme
wuͤthete	NN	wuͤthete
,	$,	,
zeigte	VVFIN	zeigen
sich	PRF	sich
hier	ADV	hier
in	APPR	in
Baireuth	NE	Baireuth
ein	ART	eine
seltenes	ADJA	selten
Phaͤnomen	NN	Phaͤnomen
.	$.	.
Waͤhrend	ADJD	Waͤhrend
der	ART	die
undruchdringlichsten	ADJA	undruchdringlichsten
Finsterniß	NN	Finsterniß
erblickte	VVFIN	erblicken
man	PIS	man
ploͤtzlich	ADJD	ploͤtzlich
im	APPRART	in+die
Suͤdwesten	NN	Suͤdwesten
beilaͤufig	ADJD	beilaͤufig
9	CARD	@card@
Grade	NN	Grad
ober	VVFIN	ober
dem	ART	die
Horizont	NN	Horizont
eine	ART	eine
durchaus	ADV	durchaus
erhellte	ADJA	erhellt
Wolke	NN	Wolke
,	$,	,
aus	APPR	aus
welcher	PRELS	welche
sich	PRF	sich
links	ADV	links
und	KON	und
rechts	ADV	rechts
Raketen	NN	Rakete
aͤhnliche	ADJA	aͤhnliche
Feuermassen	NN	Feuermassen
sehr	ADV	sehr
schnell	ADJD	schnell
auf	APPR	auf
einander	PRF	einander
in	APPR	in
Menge	NN	Menge
losrissen	VVFIN	losrissen
.	$.	.
Ein	ART	eine
Theil	NN	Theil
dieser	PDAT	dies
scheinbaren	ADJA	scheinbar
Raketen	NN	Rakete
schien	VVFIN	scheinen
einige	PIAT	einige
Secunden	NN	Secunden
lang	ADJD	lang
stille	VVFIN	stillen
zu	PTKZU	zu
stehen	VVINF	stehen
und	KON	und
verschwand	VVFIN	verschwinden
;	$.	;
die	ART	die
uͤbrigen	NN	uͤbrigen
aber	KON	aber
neigten	VVFIN	neigen
sich	PRF	sich
in	APPR	in
Boͤgen	NN	Boͤgen
erdwaͤrts	ADV	erdwaͤrts
,	$,	,
ohne	APPR	ohne
daß	KOUS	dass
man	PIS	man
bei	APPR	bei
dem	ART	die
Rasen	NN	Rasen
des	ART	die
Sturms	NN	Sturm
einen	ART	eine
Knall	NN	Knall
oder	KON	oder
Donner	NN	Donner
vernehmen	VVINF	vernehmen
konnte	VMFIN	können
.	$.	.
Gleich	ADJD	gleich
darauf	PAV	darauf
entwoͤlkte	ADJA	entwoͤlkte
sich	PRF	sich
der	ART	die
Himmel	NN	Himmel
fuͤr	ADJA	fuͤr
kurze	ADJA	kurz
Zeit	NN	Zeit
,	$,	,
und	KON	und
der	ART	die
Wind	NN	Wind
tobte	VVFIN	toben
weniger	ADV	weniger
.	$.	.
