Besonderer	ADJA	besonder
Todesfall	NN	Todesfall
.	$.	.
Zu	APPR	zu
Nochten	NN	Nochten
in	APPR	in
der	ART	die
Standesherrschaft	NN	Standesherrschaft
Muskau	NE	Muskau
ging	VVFIN	gehen
am	APPRART	an+die
7	CARD	@card@
.	$.	.
August	NN	August
die	ART	die
Magd	NN	Magd
des	ART	die
Bauers	NN	Bauer
Korla	NE	Korla
,	$,	,
Namens	APPR	namens
Hipko	NN	Hipko
,	$,	,
25	CARD	@card@
Jahr	NN	Jahr
alt	ADJD	alt
,	$,	,
gegen	APPR	gegen
Abend	NN	Abend
auf	APPR	auf
das	ART	die
Feld	NN	Feld
,	$,	,
um	KOUI	um
Viehfutter	NN	Viehfutter
zu	PTKZU	zu
holen	VVINF	holen
.	$.	.
Da	KOUS	da
sie	PPER	sie
bey	NE	Bey
eintretender	ADJA	eintretend
Nacht	NN	Nacht
nicht	PTKNEG	nicht
zuruͤckkehrte	VVFIN	zuruͤckkehrte
,	$,	,
ging	VVFIN	gehen
ihr	PPOSAT	ihr
Dienstherr	NN	Dienstherr
sie	PPER	sie
aufzusuchen	VVIZU	aufsuchen
und	KON	und
fand	VVFIN	finden
selbige	ADJA	selbige
todt	ADJA	todt
im	APPRART	in+die
Grase	NN	Gras
liegend	ADJD	liegend
.	$.	.
Bey	NE	Bey
der	ART	die
gerichtlichen	ADJA	gerichtlich
Untersuchung	NN	Untersuchung
zeigte	VVFIN	zeigen
sich	PRF	sich
,	$,	,
daß	KOUS	dass
ein	ART	eine
Schlagfluß	NN	Schlagfluß
,	$,	,
welchen	PRELS	welche
sich	PRF	sich
die	ART	die
Verstorbene	NN	Verstorbene
vermuthlich	ADJD	vermuthlich
durch	APPR	durch
starke	ADJA	stark
Erhitzung	NN	Erhitzung
–	$(	-
sie	PPER	sie
hatte	VAFIN	haben
naͤmlich	ADJD	naͤmlich
den	ART	die
ganzen	ADJA	ganz
Tag	NN	Tag
in	APPR	in
der	ART	die
Erndte	NN	Erndte
gearbeitet	VVPP	arbeiten
–	$(	-
und	KON	und
dann	ADV	dann
durch	APPR	durch
das	ART	die
Erkalten	NN	Erkalten
im	APPRART	in+die
bethauten	ADJA	bethauten
Grase	NN	Gras
zugezogen	VVPP	zuziehen
,	$,	,
ihr	PPOSAT	ihr
Ende	NN	Ende
herbeygefuͤhret	VVFIN	herbeygefuͤhret
.	$.	.
