Breslau	NE	Breslau
vom	APPRART	von+die
23	CARD	@card@
.	$.	.
Mai	NE	Mai
.	$.	.
Heute	ADV	heute
entriß	VVFIN	entreißen
uns	PPER	wir
der	ART	die
Tod	NN	Tod
einen	ART	eine
unsrer	PPOSAT	unser
achtungswuͤrdigsten	ADJA	achtungswuͤrdigsten
Mitbuͤrger	NN	Mitbuͤrger
,	$,	,
den	ART	die
Huf	NN	Huf
=	$(	=
und	KON	und
Waffenschmidt	NE	Waffenschmidt
=	$(	=
Aeltesten	ADJA	Aeltesten
Herrn	NN	Herr
Johann	NE	Johann
Michael	NE	Michael
Beck	NE	Beck
,	$,	,
in	APPR	in
seinem	PPOSAT	sein
noch	ADV	noch
nicht	PTKNEG	nicht
vollendeten	ADJA	vollendet
50sten	ADJA	50sten
Lebensjahre	NN	Lebensjahr
.	$.	.
Seit	APPR	seit
1796	CARD	@card@
hiesiger	ADJA	hiesig
Buͤrger	NN	Buͤrger
und	KON	und
seit	APPR	seit
Einfuͤhrung	NN	Einfuͤhrung
der	ART	die
allgemeinen	ADJA	allgemein
Staͤdteordnung	NN	Staͤdteordnung
ununterbrochen	ADJD	ununterbrochen
Stadtverordneter	NN	Stadtverordnete
,	$,	,
hat	VAFIN	haben
Er	PPER	er
als	KOKOM	als
solcher	PIS	solche
,	$,	,
als	KOKOM	als
Mitglied	NN	Mitglied
mehrer	NN	mehrer
magistratualischer	ADJA	magistratualischer
Deputationen	NN	Deputationen
und	KON	und
Commissionen	NN	Commissionen
,	$,	,
so	ADV	so
wie	KOKOM	wie
auch	ADV	auch
als	KOKOM	als
Vorsteher	NN	Vorsteher
des	ART	die
katholischen	ADJA	katholisch
Buͤrger-Hospitals	NN	Buͤrger-Hospitals
zu	APPR	zu
St.	NE	St.
Anna	NE	Anna
und	KON	und
des	ART	die
Hospitals	NN	Hospital
fuͤr	ADJA	fuͤr
alte	ADJA	alt
huͤlfslose	ADJA	huͤlfslose
Dienstbothen	NN	Dienstbothen
,	$,	,
durch	APPR	durch
regen	ADJA	rege
Eifer	NN	Eifer
fuͤr	ADJA	fuͤr
Wahrheit	NN	Wahrheit
und	KON	und
Recht	NN	Recht
,	$,	,
durch	APPR	durch
gefunde	ADJA	gefunde
praktische	ADJA	praktisch
Beurtheilungskraft	NN	Beurtheilungskraft
und	KON	und
durch	APPR	durch
eine	ART	eine
rastlose	ADJA	rastlos
uneigennuͤtzige	ADJA	uneigennuͤtzige
Thaͤtigkeit	NN	Thaͤtigkeit
fuͤr	VVFIN	fuͤr
das	ART	die
Gemein	NE	Gemein
=	$(	=
Wohl	NN	Wohl
unsrer	PPOSAT	unser
Stadt	NN	Stadt
,	$,	,
sich	PRF	sich
große	ADJA	groß
und	KON	und
bleibende	ADJA	bleibend
,	$,	,
von	APPR	von
des	ART	die
Koͤnigs	NN	Koͤnigs
Majestaͤt	ADJA	Majestaͤt
Allerhoͤchst	NN	Allerhoͤchst
Selbst	NN	Selbst
,	$,	,
durch	APPR	durch
Verleihung	NN	Verleihung
des	ART	die
allgemeinen	ADJA	allgemein
Ehrenzeichens	NN	Ehrenzeichen
zweiter	ADJA	zweit
Classe	NN	Classe
,	$,	,
anerkannte	ADJA	anerkannt
Verdienste	NN	Verdienst
erworben	VVPP	erwerben
.	$.	.
Moͤge	NN	Moͤge
sein	PPOSAT	sein
Beispiel	NN	Beispiel
recht	ADJD	recht
Viele	PIS	viele
ermuntern	VVFIN	ermuntern
,	$,	,
zu	APPR	zu
seyn	NE	seyn
was	PIS	was
er	PPER	er
war	VAFIN	sein
:	$.	:
ein	ART	eine
gleich	ADJD	gleich
guter	ADJA	gut
Mensch	NN	Mensch
,	$,	,
Unterthan	NN	Unterthan
und	KON	und
Buͤrger	NN	Buͤrger
,	$,	,
Stets	ADV	stets
werden	VAFIN	werden
wir	PPER	wir
seiner	PPOSAT	sein
in	APPR	in
Ehren	NN	Ehre|Ehren
,	$,	,
aber	KON	aber
auch	ADV	auch
mit	APPR	mit
Schmerz	NN	Schmerz
uͤber	NN	uͤber
seinen	PPOSAT	sein
zu	APPR	zu
fruͤhen	ADJA	fruͤhen
Verlust	NN	Verlust
,	$,	,
gedenken	VVFIN	gedenken
.	$.	.
Sanft	ADJD	sanft
ruhe	VVFIN	ruhen
seine	PPOSAT	sein
Asche	NN	Asche
!	$.	!
Ober	NN	Ober
=	$(	=
Buͤrgermeister	NN	Buͤrgermeister
,	$,	,
Buͤrgermeister	NN	Buͤrgermeister
und	KON	und
Stadt	NN	Stadt
=	$(	=
Raͤthe	NE	Raͤthe
.	$.	.
