Pleß	NN	Pleß
den	ART	die
4	CARD	@card@
.	$.	.
Septbr	NE	Septbr
.	$.	.
Nach	APPR	nach
von	APPR	von
mehreren	PIAT	mehrere
Seiten	NN	Seite
eingegangenen	ADJA	eingegangen
Nachrichten	NN	Nachricht
ist	VAFIN	sein
der	ART	die
Courier	NN	Courier
,	$,	,
der	PRELS	die
vom	APPRART	von+die
Berliner	ADJA	Berliner
Cabinet	NN	Cabinet
nach	APPR	nach
Paris	NE	Paris
einer	ART	eine
entscheidenden	ADJA	entscheidend
Antwort	NN	Antwort
geschickt	VVPP	schicken
wurde	VAFIN	werden
,	$,	,
mit	APPR	mit
der	ART	die
Versicherung	NN	Versicherung
zuruͤckgekommen	VVFIN	zuruͤckgekommen
,	$,	,
daß	KOUS	dass
Alles	NN	All
wird	VAFIN	werden
entfernt	ADJD	entfernt
werden	VAINF	werden
,	$,	,
was	PRELS	was
nur	ADV	nur
im	APPRART	in+die
Geringsten	NN	Geringste
Veranlaßung	NN	Veranlaßung
zu	APPR	zu
einem	ART	eine
Bruch	NN	Bruch
zwischen	APPR	zwischen
diesen	PDAT	dies
beiden	PIAT	beide
Maͤchten	NN	Maͤchten
geben	VVINF	geben
koͤnnte	VVFIN	koͤnnte
.	$.	.
–	$(	-
Nachdem	KOUS	nachdem
der	ART	die
bisherige	ADJA	bisherig
Preußische	ADJA	preußisch
Gesandte	NN	Gesandte
in	APPR	in
Paris	NE	Paris
,	$,	,
Marquis	NN	Marquis
v.	APPR	von
Lucchesini	NE	Lucchesini
,	$,	,
von	APPR	von
diesem	PDAT	dies
Posten	NN	Posten
zuruͤck	NN	zuruͤck
berufen	VVPP	berufen
worden	VAPP	werden
,	$,	,
so	ADV	so
ist	VAFIN	sein
der	ART	die
General	NN	General
von	APPR	von
Knobelsdorf	NN	Knobelsdorf
als	KOKOM	als
außerordentlicher	ADJA	außerordentlich
Gesandter	ADJA	gesandt
zur	APPRART	zu+die
gaͤnzlichen	ADJA	gaͤnzlichen
Beilegung	NN	Beilegung
aller	PIAT	alle
Mißverstaͤndisse	NN	Mißverstaͤndisse
nach	APPR	nach
Paris	NE	Paris
abgegangen	VVPP	abgehen
.	$.	.
Seine	PPOSAT	sein
Ruͤckkunft	NN	Ruͤckkunft
wird	VAFIN	werden
den	ART	die
endlichen	ADJA	endlich
Frieden	NN	Frieden
,	$,	,
wenigstens	ADV	wenigstens
was	PWS	was
Deutschland	NE	Deutschland
betrift	VVFIN	betrift
,	$,	,
gewiß	ADJD	gewiss
mitbringen	VVFIN	mitbringen
.	$.	.
