Deutschland	NE	Deutschland
.	$.	.
Durch	APPR	durch
eine	ART	eine
königl	NE	königl
.	$.	.
baierische	ADJA	baierische
Verordnung	NN	Verordnung
vom	APPRART	von+die
19	CARD	@card@
.	$.	.
Dec	NE	Dec
.	$.	.
wird	VAFIN	werden
,	$,	,
die	ART	die
Knöpfe	NN	Knopf
mit	APPR	mit
dem	ART	die
gekrönten	ADJA	gekrönt
Löwen	NN	Löwe
ausgenommen	VVPP	ausnehmen
,	$,	,
den	ART	die
Herrschaftsrichtern	NN	Herrschaftsrichtern
die	ART	die
nemliche	ADJA	nemliche
Uniform	NN	Uniform
,	$,	,
wie	KOUS	wie
den	ART	die
königlichen	ADJA	königlich
Landrichtern	NN	Landrichtern
bewilligt	VVPP	bewilligen
.	$.	.
In	APPR	in
den	ART	die
Kirchen	NN	Kirche
des	ART	die
Großherzogthums	NN	Großherzogthums
Baden	NE	Baden
haben	VAFIN	haben
am	APPRART	an+die
24	CARD	@card@
.	$.	.
Dec	NE	Dec
.	$.	.
die	ART	die
öffentlichen	ADJA	öffentlich
Gebete	NN	Gebet
,	$,	,
wegen	APPR	wegen
der	ART	die
gesegneten	ADJA	gesegnet
Leibesumstände	NN	Leibesumstände
I.	NE	I.
k.	NN	k.
H.	NE	H.
der	ART	die
Großherzogin	NN	Großherzogin
,	$,	,
ihren	PPOSAT	ihr
Anfang	NN	Anfang
genommen	VVPP	nehmen
.	$.	.
Durch	APPR	durch
Mannheim	NE	Mannheim
passirten	NN	passirten
kürzlich	ADJD	kürzlich
wieder	ADV	wieder
,	$,	,
aus	APPR	aus
Frankreich	NE	Frankreich
kommend	ADJD	kommend
,	$,	,
mehrere	PIAT	mehrere
kleine	ADJA	klein
Abtheilungen	NN	Abtheilungen
russischer	ADJA	russisch
und	KON	und
baierischer	ADJA	baierischer
Truppen	NN	Truppe
;	$.	;
besonders	ADV	besonders
viel	PIAT	viele
baierisches	ADJA	baierisches
Fuhrwesen	NN	Fuhrwesen
und	KON	und
ein	ART	eine
Artillerietrain	NN	Artillerietrain
.	$.	.
Zu	APPR	zu
Frankfurt	NE	Frankfurt
übergab	VVFIN	übergeben
am	APPRART	an+die
18	CARD	@card@
.	$.	.
Dec	NE	Dec
.	$.	.
Hr.	NN	Hr.
v.	APPR	von
Stralenheim	NN	Stralenheim
dem	ART	die
Senate	NN	Senat
sein	PPOSAT	sein
Kreditiv	NN	Kreditiv
als	KOKOM	als
königl	ADJD	königl
.	$.	.
großbritannisch	ADJD	großbritannisch
=	$(	=
hannoverscher	ADJA	hannoverscher
Geschäftsträger	NN	Geschäftsträger
.	$.	.
