Am	APPRART	an+die
27	CARD	@card@
.	$.	.
Dez.	NN	Dez.
,	$,	,
Abends	NN	Abend
um	APPR	um
halb	ADJD	halb
acht	CARD	acht
Uhr	NN	Uhr
wurde	VAFIN	werden
im	APPRART	in+die
Wirthshause	NN	Wirthshause
zu	PTKVZ	zu
Kling	VVIMP	klingen
,	$,	,
Landgerichts	NN	Landgericht
Wasserburg	NN	Wasserburg
,	$,	,
der	PRELS	die
schon	ADV	schon
längst	ADV	längst
zur	APPRART	zu+die
Spähe	VVFIN	spähen
ausgeschriebene	ADJA	ausgeschrieben
Anton	NE	Anton
Gabler	NN	Gabler
,	$,	,
Schleiferssohn	NN	Schleiferssohn
von	APPR	von
Torteneck	NN	Torteneck
,	$,	,
Landger	NE	Landger
.	$.	.
Trostberg	NE	Trostberg
,	$,	,
von	APPR	von
2	CARD	@card@
Gendarmen	NN	Gendarm
arretirt	NN	arretirt
.	$.	.
Derselbe	PDS	derselbe
trug	VVFIN	tragen
bei	APPR	bei
sich	PRF	sich
:	$.	:
eine	ART	eine
geladene	ADJA	geladen
lange	ADJA	lang
Pistole	NN	Pistole
mit	APPR	mit
aufgestecktem	ADJA	aufgestecktem
Kapsel	NN	Kapsel
,	$,	,
ein	ART	eine
Schachterl	NE	Schachterl
mit	APPR	mit
Schrott	NN	Schrott
,	$,	,
5	CARD	@card@
verschiedene	ADJA	verschieden
Dietriche	NN	Dietriche
,	$,	,
verschiedene	ADJA	verschieden
Brandstoffe	NN	Brandstoffe
,	$,	,
mehrere	PIAT	mehrere
mit	APPR	mit
Schwefel	NN	Schwefel
getränkte	ADJA	getränkte
Stücke	NN	Stück
Schwamm	NN	Schwamm
.	$.	.
Als	KOKOM	als
Gabler	NN	Gabler
die	ART	die
Gendarmen	NN	Gendarm
bemerkte	VVFIN	bemerken
,	$,	,
warf	VVFIN	werfen
er	PPER	er
die	ART	die
Zündstoffe	NN	Zündstoffe
von	APPR	von
sich	PRF	sich
,	$,	,
und	KON	und
wollte	VMFIN	wollen
nach	APPR	nach
der	ART	die
Pistole	NN	Pistole
greifen	VVINF	greifen
,	$,	,
wozu	PWAV	wozu
ihm	PPER	er
jedoch	ADV	jedoch
dieselben	PDAT	dieselb
keine	PIAT	keine
Zeit	NN	Zeit
mehr	ADV	mehr
ließen	VVFIN	lassen
.	$.	.
