Krakau	NE	Krakau
den	ART	die
1	CARD	@card@
.	$.	.
Septbr	NE	Septbr
.	$.	.
Alle	PIS	alle
die	ART	die
so	ADV	so
sicher	ADJD	sicher
und	KON	und
anscheinend	ADJD	anscheinend
glaubwuͤrdig	ADJD	glaubwuͤrdig
verbreiteten	ADJA	verbreitet
Nachrichten	NN	Nachricht
vond	VVFIN	vond
er	PPER	er
Ankunft	NN	Ankunft
der	ART	die
Russen	NN	Russe
und	KON	und
ihrem	PPOSAT	ihr
Beitritt	NN	Beitritt
zu	APPR	zu
einer	ART	eine
neuen	ADJA	neu
Coalition	NN	Coalition
,	$,	,
sind	VAFIN	sein
durchaus	ADV	durchaus
unbegruͤndet	ADJD	unbegruͤndet
.	$.	.
Mehrere	PIAT	mehrere
Reisende	NN	Reisende
aus	APPR	aus
Petersburg	NE	Petersburg
versichern	VVFIN	versichern
,	$,	,
daß	KOUS	dass
fuͤr	VVFIN	fuͤr
jetzt	ADV	jetzt
nicht	PTKNEG	nicht
der	ART	die
geringste	ADJA	gering
Anschein	NN	Anschein
dazu	PAV	dazu
ist	VAFIN	sein
.	$.	.
Auch	ADV	auch
bei	APPR	bei
uns	PPER	wir
sind	VAFIN	sein
alle	PIAT	alle
kriegerische	ADJA	kriegerisch
Anstalten	NN	Anstalt
contremandirt	NN	contremandirt
worden	VAPP	werden
,	$,	,
und	KON	und
wir	PPER	wir
wuͤrden	VVFIN	wuͤrden
gar	ADV	gar
nicht	PTKNEG	nicht
an	APPR	an
kriegerische	ADJA	kriegerisch
Verhaͤltnisse	NN	Verhaͤltnisse
erinnert	VVPP	erinnern
werden	VAINF	werden
,	$,	,
saͤhen	VVFIN	saͤhen
wir	PPER	wir
nicht	PTKNEG	nicht
bei	APPR	bei
uns	PPER	wir
so	ADV	so
viele	PIAT	viele
Preußische	ADJA	preußisch
Deserteurs	NN	Deserteur
,	$,	,
und	KON	und
saͤnke	VVFIN	saͤnke
unser	PPOSAT	unser
Papiergeld	NN	Papiergeld
nicht	PTKNEG	nicht
immer	ADV	immer
mehr	ADV	mehr
.	$.	.
