Linz	NE	Linz
.	$.	.
Das	ART	die
Convent	NN	Convent
der	ART	die
barmherzigen	ADJA	barmherzig
Brüder	NN	Bruder
erfüllet	VVFIN	erfüllet
mit	APPR	mit
Freude	NN	Freude
eine	ART	eine
unerläßliche	ADJA	unerlässlich
Pflicht	NN	Pflicht
,	$,	,
indem	KOUS	indem
es	PPER	es
,	$,	,
tief	ADJD	tief
gerührten	ADJA	gerührt
Herzens	NN	Herz
in	APPR	in
seinem	PPOSAT	sein
und	KON	und
der	ART	die
armen	ADJA	arm
Kranken	NN	Kranke
Namen	NN	Name
,	$,	,
den	ART	die
hochgesinnten	ADJA	hochgesinnten
Bewohnern	NN	Bewohner
dieser	PDAT	dies
Provinzial	NN	Provinzial
=	$(	=
Hauptstadt	NN	Hauptstadt
,	$,	,
namentlich	ADJD	namentlich
einem	ART	eine
hohen	ADJA	hoch
Adel	NN	Adel
,	$,	,
den	ART	die
innigsten	ADJA	innig
Dank	NN	Dank
abstattet	VVFIN	abstatten
,	$,	,
für	APPR	für
die	PRELS	die
werkthätig	ADJD	werkthätig
bezeigte	ADJA	bezeigt
Theilnahme	NN	Theilnahme
an	APPR	an
der	ART	die
Vorstellung	NN	Vorstellung
,	$,	,
welche	PRELS	welche
am	APPRART	an+die
31	CARD	@card@
.	$.	.
März	NN	März
1841	CARD	@card@
zum	APPRART	zu+die
Besten	NN	Beste
des	ART	die
Hospitals	NN	Hospital
durch	APPR	durch
die	ART	die
anspruchlose	ADJA	anspruchlose
Güte	NN	Güte
des	ART	die
Herrn	NN	Herr
Directors	NN	Directors
Joseph	NE	Joseph
Pellet	VVFIN	Pellet
mit	APPR	mit
allem	PIS	alle
Fleiße	NN	Fleiße
und	KON	und
gelungenen	ADJA	gelungen
Streben	NN	Strebe|Streben
von	APPR	von
Seite	NN	Seite
der	ART	die
sehr	ADV	sehr
talentirten	ADJA	talentirten
Mitglieder	NN	Mitglied
dieser	PDAT	dies
Schaubühne	NN	Schaubühne
gegeben	VVPP	geben
wurde	VAFIN	werden
.	$.	.
Eben	ADV	eben
so	ADV	so
bittet	VVFIN	bitten
das	ART	die
Convent	NN	Convent
des	ART	die
genannten	ADJA	genannt
Ordens	NN	Orden
,	$,	,
ein	ART	eine
löbliches	ADJA	löblich
Regiments-Commando	NN	Regiments-Commando
wolle	VMFIN	wollen
die	ART	die
Versicherung	NN	Versicherung
genehmigen	VVINF	genehmigen
,	$,	,
daß	KOUS	dass
es	PPER	es
nie	ADV	nie
der	ART	die
Wohlthat	NN	Wohlthat
vergessen	VVPP	vergessen
werde	VAFIN	werden
,	$,	,
welche	PRELS	welche
ihm	PPER	er
durch	APPR	durch
die	ART	die
unentgeldliche	ADJA	unentgeldliche
Ueberlassung	NN	Ueberlassung
der	ART	die
kunstausgebildeten	ADJA	kunstausgebildeten
Capelle	NN	Capelle
vom	APPRART	von+die
Baron	NN	Baron
Hrabrowsky	NE	Hrabrowsky
Infanterie	NN	Infanterie
=	$(	=
Reg.	NN	Reg.
großmüthig	ADJD	großmüthig
erwiesen	VVPP	erweisen
wurde	VAFIN	werden
.	$.	.
Den	ART	die
vereinten	ADJA	vereint
liebevollen	ADJA	liebevoll
Kräften	NN	Kraft
verdankt	VVFIN	verdanken
das	ART	die
Hospital	NN	Hospital
nach	APPR	nach
Abschlag	NN	Abschlag
aller	PIAT	alle
Unkosten	NN	Unkosten
den	ART	die
reinen	ADJA	rein
Ertrag	NN	Ertrag
von	APPR	von
335	CARD	@card@
fl	NE	fl
.	$.	.
38	CARD	@card@
kr.	NE	kr.
WW	NE	WW
.	$.	.
Das	ART	die
Auge	NN	Auge
,	$,	,
das	PRELS	die
mit	APPR	mit
Barmherzigkeit	NN	Barmherzigkeit
die	ART	die
leidende	ADJA	leidend
Menschheit	NN	Menschheit
sieht	VVFIN	sehen
,	$,	,
blickt	VVFIN	blicken
auch	ADV	auch
auf	APPR	auf
ihre	PPOSAT	ihr
Wohlthaten	NN	Wohlthaten
,	$,	,
edle	ADJA	edel
Menschenfreunde	NN	Menschenfreund
!	$.	!
–	$(	-
und	KON	und
mit	APPR	mit
reichen	ADJA	reich
Zinsen	NN	Zins
wird	VAFIN	werden
der	ART	die
Allvater	NN	Allvater
Ihnen	PPER	Sie
vergelten	VVINF	vergelten
,	$,	,
die	PRELS	die
Sie	PPER	Sie
ihrer	PPOSAT	ihr
Brüder	NN	Bruder
nicht	PTKNEG	nicht
vergassen	VVFIN	vergessen
.	$.	.
