Allerhand	ADJD	allerhand
.	$.	.
Aufforderung	NN	Aufforderung
an	APPR	an
Menschenfreunde	NN	Menschenfreund
.	$.	.
In	APPR	in
der	ART	die
Nacht	NN	Nacht
vom	APPRART	von+die
16	CARD	@card@
.	$.	.
zum	APPRART	zu+die
17	CARD	@card@
.	$.	.
dieses	PDS	diese
brach	VVFIN	brechen
hier	ADV	hier
in	APPR	in
einer	ART	eine
Scheune	NN	Scheune
ein	ART	eine
Feuer	NN	Feuer
aus	PTKVZ	aus
,	$,	,
welches	PWAT	welche
,	$,	,
angefacht	VVPP	anfachen
durch	APPR	durch
einen	ART	eine
heftigen	ADJA	heftig
Wind	NN	Wind
,	$,	,
mit	APPR	mit
verheerender	ADJA	verheerend
Wuth	NE	Wuth
um	APPR	um
sich	PRF	sich
griff	VVFIN	greifen
,	$,	,
so	ADV	so
daß	KOUS	dass
binnen	APPR	binnen
zwey	NE	zwey
Stunden	NN	Stunde|Stunden
funfzehn	ADJA	funfzehn
Haͤuser	NN	Haͤuser
,	$,	,
eilf	ADJA	eilf
Nebengebaͤude	NN	Nebengebaͤude
und	KON	und
neun	CARD	neun
Scheunen	NN	Scheune
von	APPR	von
den	ART	die
Flammen	NN	Flamme
verzehrt	VVPP	verzehren
und	KON	und
verschiedene	ADJA	verschieden
andere	PIAT	andere
Gebaͤude	NN	Gebaͤude
stark	ADJD	stark
beschaͤdigt	VVPP	beschaͤdigt
wurden	VAFIN	werden
.	$.	.
Sieben	CARD	sieben
und	KON	und
zwanzig	CARD	zwanzig
Familien	NN	Familie
,	$,	,
in	APPR	in
hundert	CARD	hundert
und	KON	und
neun	CARD	neun
Personen	NN	Person
bestehend	ADJD	bestehend
,	$,	,
verloren	VVFIN	verlieren
ihr	PPOSAT	ihr
Obdach	NN	Obdach
und	KON	und
den	ART	die
bey	NE	Bey
weitem	ADJA	weit
groͤßten	ADJA	groͤßten
Theil	NN	Theil
ihrer	PPOSAT	ihr
Habe	NN	Habe
.	$.	.
Denn	KON	denn
die	ART	die
Schnelligkeit	NN	Schnelligkeit
,	$,	,
mit	APPR	mit
welcher	PRELS	welche
das	ART	die
Feuer	NN	Feuer
sich	PRF	sich
verbreitete	VVFIN	verbreiten
,	$,	,
noͤthigte	VVFIN	noͤthigte
die	ART	die
Ungluͤcklichen	NN	Ungluͤcklichen
,	$,	,
nur	ADV	nur
an	APPR	an
ihre	PPOSAT	ihr
persoͤnliche	ADJA	persoͤnliche
Sicherheit	NN	Sicherheit
zu	PTKZU	zu
denken	VVINF	denken
,	$,	,
und	KON	und
erlaubte	VVFIN	erlauben
kaum	ADV	kaum
einen	ART	eine
Versuch	NN	Versuch
zu	APPR	zu
Rettung	NN	Rettung
ihres	PPOSAT	ihr
Eigenthums	NN	Eigenthums
.	$.	.
Der	ART	die
groͤßte	ADJA	groͤßte
Theil	NN	Theil
der	ART	die
,	$,	,
von	APPR	von
diesem	PDAT	dies
Ungluͤcke	NN	Ungluͤcke
Betroffenen	NN	Betroffene
gehoͤrte	VVFIN	gehoͤrte
schon	ADV	schon
vorher	ADV	vorher
zu	APPR	zu
den	ART	die
Duͤrftigen	NN	Duͤrftigen
und	KON	und
ist	VAFIN	sein
nun	ADV	nun
in	APPR	in
die	ART	die
druͤckendste	ADJA	druͤckendste
Armuth	NN	Armuth
gestuͤrzt	VVPP	gestuͤrzt
.	$.	.
Schmerzlich	ADJD	schmerzlich
ist	VAFIN	sein
der	ART	die
Anblick	NN	Anblick
der	ART	die
Noth	NE	Noth
und	KON	und
des	ART	die
Elends	NN	Elend
,	$,	,
welches	PRELS	welche
dieser	PDAT	dies
verheerende	ADJA	verheerend
Brand	NN	Brand
verbreitete	VVFIN	verbreiten
;	$.	;
doch	ADV	doch
troͤstet	VVFIN	troͤstet
dabey	NE	dabey
die	ART	die
,	$,	,
auf	APPR	auf
vielfache	ADJA	vielfach
wohlthuende	ADJA	wohlthuende
Erfahrungen	NN	Erfahrung
gegruͤndete	VVPP	gegruͤndete
Ueberzeugung	NN	Ueberzeugung
,	$,	,
daß	KOUS	dass
noch	ADV	noch
nie	ADV	nie
der	ART	die
Huͤlferuf	NN	Huͤlferuf
für	APPR	für
Verungluͤckte	NN	Verungluͤckte
ungehoͤrt	ADJD	ungehoͤrt
verhallte	VVFIN	verhallen
!	$.	!
Gewiß	ADJD	gewiss
leben	VVFIN	leben
in	APPR	in
der	ART	die
Naͤhe	NN	Naͤhe
und	KON	und
in	APPR	in
der	ART	die
Ferne	NN	Ferne
viele	PIAT	viele
Edeldenkende	NN	Edeldenkende
,	$,	,
welche	PRELS	welche
einst	ADV	einst
in	APPR	in
dem	ART	die
hiesigen	ADJA	hiesig
Orte	NN	Ort
und	KON	und
seiner	PPOSAT	sein
freundlichen	ADJA	freundlich
Umgebung	NN	Umgebung
frohe	ADJA	froh
Stunden	NN	Stunde|Stunden
genossen	VVPP	genießen
;	$.	;
an	APPR	an
diese	PDAT	dies
,	$,	,
so	ADV	so
wie	KOKOM	wie
an	APPR	an
alle	PIS	alle
,	$,	,
welche	PRELS	welche
gern	ADV	gern
Leidende	NN	Leidende
erquicken	VVFIN	erquicken
,	$,	,
richten	VVFIN	richten
wir	PPER	wir
vertrauungsvoll	ADJD	vertrauungsvoll
die	ART	die
Bitte	NN	Bitte
um	APPR	um
milde	ADJA	mild
Beytraͤge	NN	Beytraͤge
zur	APPRART	zu+die
Unterstuͤtzung	NN	Unterstuͤtzung
der	ART	die
Verungluͤckten	NN	Verungluͤckten
;	$.	;
gewissenhaft	ADJD	gewissenhaft
soll	VMFIN	sollen
das	PDS	die
,	$,	,
was	PRELS	was
wohlthaͤtiger	ADJA	wohlthaͤtiger
Sinn	NN	Sinn
spenden	VVINF	spenden
wird	VAFIN	werden
,	$,	,
zur	APPRART	zu+die
Unterstuͤtzung	NN	Unterstuͤtzung
der	ART	die
Duͤrftigen	NN	Duͤrftigen
verwendet	VVPP	verwenden
und	KON	und
dereinst	ADV	dereinst
oͤffentlich	ADJD	oͤffentlich
daruͤber	ADJA	daruͤber
Rechnung	NN	Rechnung
abgelegt	VVPP	ablegen
werden	VAFIN	werden
.	$.	.
Koͤstritz	NE	Koͤstritz
,	$,	,
den	ART	die
20	CARD	@card@
.	$.	.
August	NN	August
1829	CARD	@card@
.	$.	.
F.	NE	F.
Sturm	NE	Sturm
.	$.	.
F.	APPR	f.
C.	NE	C.
Otto	NE	Otto
.	$.	.
Dr.	NN	Dr.
Schottin	NN	Schottin
.	$.	.
Schottin	NN	Schottin
,	$,	,
Pfr	NN	Pfr
.	$.	.
Kornmann	NE	Kornmann
,	$,	,
Richter	NE	Richter
.	$.	.
