Bürgermeister	NN	Bürgermeister
und	KON	und
kleiner	ADJA	klein
Rath	NE	Rath
des	ART	die
Kantons	NN	Kanton
Aargau	NN	Aargau
haben	VAFIN	haben
unterm	APPRART	unter+die
23	CARD	@card@
.	$.	.
Jan.	NE	Jan.
,	$,	,
weil	KOUS	weil
nach	APPR	nach
den	ART	die
bestehenden	ADJA	bestehend
Gesetzen	NN	Gesetz
der	ART	die
Besitz	NN	Besitz
des	ART	die
Kantonsbürgerrechts	NN	Kantonsbürgerrechts
nicht	PTKNEG	nicht
anders	ADV	anders
statt	PTKVZ	statt
finden	VVINF	finden
kann	VMFIN	können
,	$,	,
als	KOKOM	als
wenn	KOUS	wenn
derselbe	PDS	derselbe
mit	APPR	mit
dem	ART	die
Besitz	NN	Besitz
eines	ART	eine
Ortsbürgerrechts	NN	Ortsbürgerrechts
verbunden	VVPP	verbinden
ist	VAFIN	sein
,	$,	,
verordnet	VVPP	verordnen
:	$.	:
die	ART	die
Gemeinderäthe	NN	Gemeinderäthe
sollen	VMFIN	sollen
keine	PIAT	keine
Verrichtleistung	NN	Verrichtleistung
auf	APPR	auf
das	ART	die
Ortsbürgerrecht	NN	Ortsbürgerrecht
annehmen	VVINF	annehmen
,	$,	,
noch	ADV	noch
den	ART	die
Berrichtleistenden	NN	Berrichtleistenden
im	APPRART	in+die
Verzeichnisse	NN	Verzeichnis
der	ART	die
Ortsbürger	NN	Ortsbürger
durchstrichen	VVPP	durchstreichen
,	$,	,
davor	PAV	davor
sie	PPER	sie
den	ART	die
Fall	NN	Fall
der	ART	die
Regierung	NN	Regierung
zur	APPRART	zu+die
Kenntniß	NN	Kenntniß
und	KON	und
Entscheidung	NN	Entscheidung
gebracht	VVPP	bringen
haben	VAFIN	haben
.	$.	.
Eine	ART	eine
zweite	ADJA	zweit
Verordnung	NN	Verordnung
vom	APPRART	von+die
gleichen	ADJA	gleich
Tage	NN	Tag
weiset	VVFIN	weiset
die	ART	die
Gemeindsbehörden	NN	Gemeindsbehörden
an	PTKVZ	an
,	$,	,
in	APPR	in
Zukunft	NN	Zukunft
ihre	PPOSAT	ihr
sämmtlichen	ADJA	sämmtlichen
Rechnungen	NN	Rechnung
über	APPR	über
Armen	NN	Arm|Arme
=	$(	=
,	$,	,
Schul	VVIMP	schulen
=	$(	=
und	KON	und
Kirchengüter	NN	Kirchengut
,	$,	,
so	ADV	so
wie	KOKOM	wie
über	APPR	über
Bogxxxx	ADJA	Bogxxxx
in	APPR	in
Franken	NN	Franke
,	$,	,
Batzen	NN	Batzen
und	KON	und
Rappen	NN	Rappen
zu	PTKZU	zu
stellen	VVINF	stellen
,	$,	,
und	KON	und
diese	PDAT	dies
gesetzlich	ADJD	gesetzlich
eingeführte	ADJA	eingeführt
Münze	NN	Münze
auch	ADV	auch
in	APPR	in
allen	PIAT	alle
ihren	PPOSAT	ihr
übrigen	ADJA	übrig
Verhandlungen	NN	Verhandlung
zu	PTKZU	zu
gebrauchen	VVINF	gebrauchen
.	$.	.
Die	ART	die
Uebersicht	NN	Uebersicht
der	ART	die
vom	APPRART	von+die
Appellationsgericht	NN	Appellationsgericht
des	ART	die
Kantons	NN	Kanton
Aargau	NN	Aargau
ausgesprochenen	ADJA	ausgesprochen
Kriminalstrafurtheile	NN	Kriminalstrafurtheile
vom	APPRART	von+die
Jahr	NN	Jahr
1816	CARD	@card@
zeigt	VVFIN	zeigen
,	$,	,
daß	KOUS	dass
in	APPR	in
37	CARD	@card@
Kriminalprozeduren	NN	Kriminalprozeduren
65	CARD	@card@
Personen	NN	Person
verwickelt	VVPP	verwickeln
waren	VAFIN	sein
;	$.	;
daß	KOUS	dass
neun	CARD	neun
Urtheile	NN	Urtheile
des	ART	die
erstinstanzlichen	ADJA	erstinstanzlichen
Richters	NN	Richter
unbedingt	ADJD	unbedingt
bestätigt	VVPP	bestätigen
,	$,	,
und	KON	und
die	ART	die
übrigen	ADJA	übrig
mehr	ADV	mehr
oder	KON	oder
weniger	ADV	weniger
abgeändert	VVPP	abändern
wurden	VAFIN	werden
.	$.	.
Die	ART	die
einzige	ADJA	einzig
Todesstrafe	NN	Todesstrafe
,	$,	,
welche	PRELS	welche
erstinstanzlich	ADJD	erstinstanzlich
wegen	APPR	wegen
Kindermord	NN	Kindermord
ausgesprochen	VVPP	aussprechen
worden	VAPP	werden
war	VAFIN	sein
,	$,	,
hat	VAFIN	haben
das	ART	die
Appellationsgericht	NN	Appellationsgericht
in	APPR	in
zwanzigjährige	ADJA	zwanzigjährig
Kettenstrafe	NN	Kettenstrafe
verwandelt	VVPP	verwandeln
.	$.	.
Landesverweisungen	ADJD	Landesverweisungen
wurden	VAFIN	werden
nur	ADV	nur
gegen	APPR	gegen
Ausländer	NN	Ausländer
verhängt	VVPP	verhängen
.	$.	.
