München	NE	München
,	$,	,
3	CARD	@card@
.	$.	.
Januar	NN	Januar
.	$.	.
Heute	ADV	heute
Morgens	NN	Morgen
6	CARD	@card@
Uhr	NN	Uhr
brannte	VVFIN	brennen
die	ART	die
Brudermühle	NN	Brudermühle
oberhalb	APPR	oberhalb
der	ART	die
schmerzhaften	ADJA	schmerzhaft
Kapelle	NN	Kapelle
ab	PTKVZ	ab
.	$.	.
Noch	ADV	noch
ist	VAFIN	sein
nicht	PTKNEG	nicht
ermittelt	VVPP	ermitteln
,	$,	,
durch	APPR	durch
welche	PRELS	welche
Veranlassung	NN	Veranlassung
der	ART	die
Brand	NN	Brand
entstund	ADJD	entstund
.	$.	.
–	$(	-
Fuenf	NN	Fuenf
Kühe	NN	Kuh
,	$,	,
sechs	CARD	sechs
Pferde	NN	Pferd
und	KON	und
eine	ART	eine
bedeutende	ADJA	bedeutend
Quantität	NN	Quantität
Malz	NE	Malz
sind	VAFIN	sein
verbrannt	VVPP	verbrennen
.	$.	.
–	$(	-
Sonderbar	NN	Sonderbar
ist	VAFIN	sein
es	PPER	es
indeß	NN	indeß
,	$,	,
daß	KOUS	dass
man	PIS	man
bei	APPR	bei
solchen	PIAT	solche
Gelegenheiten	NN	Gelegenheit
immer	ADV	immer
so	ADV	so
viele	PIAT	viele
Frauenzimmer	NN	Frauenzimmer
,	$,	,
und	KON	und
zwar	ADV	zwar
als	KOKOM	als
die	ART	die
Ersten	NN	Erste
am	APPRART	an+die
Platze	NN	Platz
,	$,	,
sieht	VVFIN	sehen
.	$.	.
−	ADJA	−
–	$(	-
Selbst	NN	Selbst
bei	APPR	bei
den	ART	die
traurigsten	ADJA	traurig
Ereignißen	NN	Ereignißen
begeben	VVFIN	begeben
sich	PRF	sich
oft	ADV	oft
auch	ADV	auch
drollige	ADJA	drollig
Dinge	NN	Ding
.	$.	.
So	ADV	so
befand	VVFIN	befinden
sich	PRF	sich
z.	APPRART	zu+die
B.	NN	B.
heute	ADV	heute
Morgens	NN	Morgen
,	$,	,
als	KOUS	als
der	ART	die
Wächter	NN	Wächter
vom	APPRART	von+die
Frauenthurme	NN	Frauenthurme
durch	APPR	durch
das	ART	die
Sprachrohr	NN	Sprachrohr
das	ART	die
Feuer	NN	Feuer
verkündete	VVFIN	verkünden
,	$,	,
nahe	VVFIN	nahen
bei	APPR	bei
dieser	PDAT	dies
Kirche	NN	Kirche
eine	ART	eine
Magd	NN	Magd
in	APPR	in
der	ART	die
Küche	NN	Küche
,	$,	,
und	KON	und
lief	VVFIN	laufen
schnell	ADJD	schnell
zu	APPR	zu
ihren	PPOSAT	ihr
Herrn	NN	Herr
,	$,	,
und	KON	und
berichtete	VVFIN	berichten
solchem	PIS	solche
:	$.	:
„	$(	„
ein	ART	eine
kleines	ADJA	klein
Kind	NN	Kind
schreie	VVFIN	schreien
in	APPR	in
Schornsteine	NN	Schornstein
.	$.	.
“	$(	“
–	$(	-
Der	ART	die
Schall	NN	Schall
des	ART	die
Sprachrohres	NN	Sprachrohres
hatte	VAFIN	haben
sich	PRF	sich
nämlich	ADV	nämlich
in	APPR	in
den	ART	die
Schornstein	NN	Schornstein
geworfen	VVPP	werfen
.	$.	.
–	$(	-
Ist	VAFIN	sein
es	PPER	es
denn	ADV	denn
wohl	ADV	wohl
erlaubt	VVPP	erlauben
,	$,	,
daß	KOUS	dass
ein	ART	eine
Müller	NE	Müller
56	CARD	@card@
Säcke	NN	Sack
Mehl	NN	Mehl
auf	APPR	auf
einen	ART	eine
einzigen	ADJA	einzig
Wagen	NN	Wagen
ladet	VVFIN	laden
,	$,	,
und	KON	und
damit	PAV	damit
in	APPR	in
die	ART	die
Stadt	NN	Stadt
fährt	VVFIN	fahren
,	$,	,
namentlich	ADJD	namentlich
bei	APPR	bei
so	ADV	so
eisglattem	ADJA	eisglattem
Wege	NN	Weg
,	$,	,
wie	KOUS	wie
es	PPER	es
heute	ADV	heute
–	$(	-
Donnerstag	NN	Donnerstag
–	$(	-
der	ART	die
Fall	NN	Fall
war	VAFIN	sein
?	$.	?
