Linz	NE	Linz
.	$.	.
Montag	NN	Montag
,	$,	,
den	ART	die
29	CARD	@card@
.	$.	.
März	NN	März
,	$,	,
Nachmittags	NN	Nachmittags
nach	APPR	nach
4	CARD	@card@
Uhr	NN	Uhr
,	$,	,
traf	VVFIN	treffen
Se	NE	se
.	$.	.
kön	VVFIN	kön
.	$.	.
Hoheit	NN	Hoheit
der	ART	die
durchlauchtigste	ADJA	durchlauchtigste
Herr	NN	Herr
Erzherzog	NN	Erzherzog
Ferdinand	NE	Ferdinand
d'Este	NN	d'Este
in	APPR	in
Begleitung	NN	Begleitung
Seines	PPOSAT	sein
königl	NN	königl
.	$.	.
Neffen	NN	Neffe
Erzherzog	NN	Erzherzog
Ferdinand	NE	Ferdinand
,	$,	,
Sohn	NN	Sohn
Sr.	NE	Sr.
lönigl	NE	lönigl
.	$.	.
Hoheit	NN	Hoheit
des	ART	die
regierenden	ADJA	regierend
Herzogs	NN	Herzog
von	APPR	von
Modena	NE	Modena
,	$,	,
von	APPR	von
München	NE	München
kommend	ADJD	kommend
,	$,	,
im	APPRART	in+die
erwünschten	ADJA	erwünscht
Wohlsein	NN	Wohlsein
hier	ADV	hier
ein	PTKVZ	ein
,	$,	,
und	KON	und
setzten	VVFIN	setzen
nach	APPR	nach
einem	ART	eine
kurzen	ADJA	kurz
Aufenthalt	NN	Aufenthalt
von	APPR	von
zwei	CARD	zwei
Stunden	NN	Stunde|Stunden
Ihre	PPOSAT	ihr
Reise	NN	Reise
nach	APPR	nach
Wien	NE	Wien
fort	PTKVZ	fort
.	$.	.
