Bayern	NE	Bayern
.	$.	.
Kempten	NE	Kempten
,	$,	,
24	CARD	@card@
.	$.	.
Januar	NN	Januar
.	$.	.
Heute	ADV	heute
Nachmittag	NN	Nachmittag
wurde	VAFIN	werden
der	ART	die
Commis	NN	Commis
der	ART	die
Dannheimer	ADJA	Dannheimer
'	$(	'
schen	ADJA	schen
Buchhandlung	NN	Buchhandlung
,	$,	,
Hr.	NN	Hr.
Fischer	NE	Fischer
,	$,	,
nach	APPR	nach
einem	ART	eine
Verhör	NN	Verhör
in	APPR	in
die	ART	die
Frohnveste	NN	Frohnveste
abgeführt	VVPP	abführen
.	$.	.
Er	PPER	er
war	VAFIN	sein
es	PPER	es
,	$,	,
der	PRELS	die
die	ART	die
verhängnißvolle	ADJA	verhängnißvolle
Anzeige	NN	Anzeige
des	ART	die
Struve	NN	Struve
'	$(	'
schen	ADJA	schen
Kalenders	NN	Kalender
in	APPR	in
die	ART	die
Druckerei	NN	Druckerei
schickte	VVFIN	schicken
.	$.	.
Den	ART	die
Inhalt	NN	Inhalt
des	ART	die
Kalenders	NN	Kalender
kannte	VVFIN	kennen
er	PPER	er
nicht	PTKNEG	nicht
,	$,	,
und	KON	und
es	PPER	es
wird	VAFIN	werden
daher	PAV	daher
hoffentlich	ADV	hoffentlich
seine	PPOSAT	sein
Haft	NN	Haft
von	APPR	von
sehr	ADV	sehr
kurzer	ADJA	kurz
Dauer	NN	Dauer
sein	VAINF	sein
;	$.	;
denn	KON	denn
es	PPER	es
besteht	VVFIN	bestehen
nirgends	ADV	nirgends
eine	ART	eine
Verbindlichkeit	NN	Verbindlichkeit
für	APPR	für
den	ART	die
Buchhändler	NN	Buchhändler
,	$,	,
die	ART	die
Schriften	NN	Schrift
,	$,	,
welche	PRELS	welche
er	PPER	er
anzeigt	VVFIN	anzeigen
,	$,	,
zuvor	ADV	zuvor
zu	PTKZU	zu
lesen	VVINF	lesen
.	$.	.
