Klagenfurt	NN	Klagenfurt
.	$.	.
Vorgestern	ADV	vorgestern
den	ART	die
11	CARD	@card@
.	$.	.
Traf	VVFIN	treffen
die	ART	die
4te	ADJA	4te
Division	NN	Division
von	APPR	von
Kaiser	NE	Kaiser
Uhlanen	VVFIN	Uhlanen
hier	ADV	hier
ein	PTKVZ	ein
,	$,	,
und	KON	und
sezte	VVFIN	sezte
gestern	ADV	gestern
Fruͤh	NN	Fruͤh
ihren	PPOSAT	ihr
Marsch	NN	Marsch
nach	APPR	nach
Mayland	NE	Mayland
fort	PTKVZ	fort
,	$,	,
allwo	VVFIN	allwo
sich	PRF	sich
bereits	ADV	bereits
die	ART	die
3	CARD	@card@
andern	PIAT	andere
Divisionen	NN	Division
dieses	PDAT	dies
Regiments	NN	Regiment
befinden	VVINF	befinden
.	$.	.
Einige	PIAT	einige
Stunden	NN	Stunde|Stunden
darauf	PAV	darauf
ruͤckten	VVFIN	ruͤckten
2	CARD	@card@
Bataillone	NN	Bataillon
vom	APPRART	von+die
Infant	NN	Infant
.	$.	.
Regimente	ADJA	Regimente
B.	NN	B.
Zach	VVFIN	Zach
ein	PTKVZ	ein
,	$,	,
und	KON	und
marschirten	VVFIN	marschirten
heute	ADV	heute
Fruͤh	NN	Fruͤh
wieder	ADV	wieder
von	APPR	von
hier	ADV	hier
in	APPR	in
ihre	PPOSAT	ihr
Friedensstation	NN	Friedensstation
ab	PTKVZ	ab
.	$.	.
Das	ART	die
dritte	ADJA	dritt
und	KON	und
erste	ADJA	erst
Landwehrbataillon	NN	Landwehrbataillon
dieses	PDAT	dies
Regiments	NN	Regiment
erwarten	VVFIN	erwarten
wir	PPER	wir
,	$,	,
welche	PRELS	welche
den	ART	die
nemlichen	ADJA	nemlichen
Weg	NN	Weg
einschlagen	VVINF	einschlagen
werden	VAFIN	werden
.	$.	.
Überdieß	NN	Überdieß
sollen	VMFIN	sollen
ausser	APPR	außer
den	ART	die
fast	ADV	fast
taͤglich	ADJD	taͤglich
ankommenden	ADJA	ankommend
verschiedenen	ADJA	verschieden
Truppen	NN	Truppe
Abtheilungen	NN	Abtheilungen
,	$,	,
noch	ADV	noch
mehrere	PIAT	mehrere
Durschmaͤrsche	NN	Durschmaͤrsche
hier	ADV	hier
statt	PTKVZ	statt
finden	VVFIN	finden
.	$.	.
