Augsburg	NE	Augsburg
,	$,	,
den	ART	die
30	CARD	@card@
.	$.	.
Aug.	NN	Aug.
Der	ART	die
diesjaͤhrige	ADJA	diesjaͤhrige
Lehrkurs	NN	Lehrkurs
in	APPR	in
den	ART	die
hiesigen	ADJA	hiesig
hoͤhern	NN	hoͤhern
Lehranstalten	NN	Lehranstalt
schloß	VVFIN	schließen
sich	PRF	sich
,	$,	,
nach	APPR	nach
den	ART	die
geendigten	ADJA	geendigten
Pruͤfungen	NN	Pruͤfungen
,	$,	,
heute	ADV	heute
mit	APPR	mit
der	ART	die
allerhoͤchst	ADJD	allerhoͤchst
verordneten	ADJA	verordnet
Deklamation	NN	Deklamation
und	KON	und
der	ART	die
feyerlichen	ADJA	feyerlichen
Preisevertheilung	NN	Preisevertheilung
,	$,	,
welche	PRELS	welche
Feyerlichkeiten	NN	Feyerlichkeiten
mehrere	PIAT	mehrere
der	ART	die
hier	ADV	hier
anwesenden	ADJA	anwesend
koͤnigl	NN	koͤnigl
.	$.	.
Stellen	NN	Stelle|Stellen
und	KON	und
ein	ART	eine
zahlreiches	ADJA	zahlreich
Auditorium	NN	Auditorium
durch	APPR	durch
ihre	PPOSAT	ihr
fuͤr	ADJA	fuͤr
Lehrer	NN	Lehrer
und	KON	und
Schuͤler	NN	Schuͤler
ermunternde	ADJA	ermunternd
Gegenwart	NN	Gegenwart
beehrten	VVFIN	beehren
.	$.	.
Sowohl	KON	sowohl
die	ART	die
Pruͤfungen	NN	Pruͤfungen
als	KOKOM	als
die	ART	die
heutige	ADJA	heutig
Schlußfeyer	NN	Schlußfeyer
schien	VVFIN	scheinen
zu	PTKZU	zu
beweisen	VVINF	beweisen
,	$,	,
daß	KOUS	dass
es	PPER	es
den	ART	die
Lehranstalten	NN	Lehranstalt
gelungen	VVPP	gelingen
ist	VAFIN	sein
,	$,	,
den	ART	die
Absichten	NN	Absicht
unsrer	PPOSAT	unser
fuͤr	NN	fuͤr
die	ART	die
Erziehung	NN	Erziehung
so	ADV	so
vaͤterlich	ADJD	vaͤterlich
besorgten	ADJA	besorgt
Regierung	NN	Regierung
zu	PTKZU	zu
entsprechen	VVINF	entsprechen
.	$.	.
Neben	APPR	neben
andern	PIAT	andere
gute	ADJA	gut
Fruͤchte	NN	Fruͤchte
versprechenden	ADJA	versprechend
Bluͤhten	NN	Bluͤhten
hatte	VAFIN	haben
auch	ADV	auch
der	ART	die
vor	APPR	vor
Kurzem	NN	Kurze
errichtete	VVFIN	errichten
musikalische	ADJA	musikalisch
Verein	NN	Verein
,	$,	,
dessen	PRELAT	die
rasches	ADJA	rasch
Aufbluͤhen	NN	Aufbluͤhen
von	APPR	von
der	ART	die
thaͤtigen	ADJA	thaͤtigen
Mitwirkung	NN	Mitwirkung
des	ART	die
Herrn	NN	Herr
Dr.	NN	Dr.
der	ART	die
Rechte	NN	Recht|Rechte
von	APPR	von
Ahorner	NN	Ahorner
und	KON	und
seines	PPOSAT	sein
Freundes	NN	Freund
Herrn	NN	Herr
Dr.	NN	Dr.
Holzmann	NE	Holzmann
zeugt	VVFIN	zeugen
,	$,	,
unter	APPR	unter
Direktion	NN	Direktion
unsers	PPOSAT	unser
so	ADV	so
ruͤhmlich	ADJD	ruͤhmlich
bekannten	ADJA	bekannt
Herrn	NN	Herr
Musikdirektors	NN	Musikdirektor
Haͤusler	NN	Haͤusler
,	$,	,
neben	APPR	neben
mehreren	PIAT	mehrere
gelungenen	ADJA	gelungen
Stuͤcken	NN	Stuͤcken
auch	ADV	auch
eine	PIS	eine
vom	APPRART	von+die
Oberprogymnasiallehrer	NN	Oberprogymnasiallehrer
Herrn	NN	Herr
Schuͤlein	NN	Schuͤlein
verfertigte	VVFIN	verfertigen
und	KON	und
von	APPR	von
dem	ART	die
jungen	ADJA	jung
hoffnungsvollen	ADJA	hoffnungsvoll
Oberprimaͤrschueler	NN	Oberprimaͤrschueler
Heis	NN	Heis
komponirte	NN	komponirte
Kantate	NN	Kantate
aufgefuͤhrt	VVPP	aufgefuͤhrt
,	$,	,
welche	PRELS	welche
den	ART	die
Beifall	NN	Beifall
der	ART	die
Zuhoͤrer	ADJA	Zuhoͤrer
fand	VVFIN	finden
.	$.	.
