—	$,	—
Freiburg	NE	Freiburg
den	ART	die
25	CARD	@card@
.	$.	.
Mai	NN	Mai
1832	CARD	@card@
.	$.	.
Heute	ADV	heute
verließ	VVFIN	verlassen
uns	PPER	wir
das	ART	die
2te	ADJA	2te
Linien	NN	Linie
=	$(	=
Infanterie	NN	Infanterie
=	$(	=
Regiment	NN	Regiment
,	$,	,
welches	PRELS	welche
13	CARD	@card@
Jahre	NN	Jahr
ununterbrochen	ADJD	ununterbrochen
hier	ADV	hier
als	KOKOM	als
Garnison	NN	Garnison
lag	VVFIN	liegen
,	$,	,
und	KON	und
gleichsam	ADJD	gleichsam
eingebürgert	VVPP	einbürgern
war	VAFIN	sein
.	$.	.
Mit	APPR	mit
wenigen	PIAT	wenige
seltenen	ADJA	selten
Ausnahmen	NN	Ausnahme
bestund	NE	bestund
fortwährend	ADJD	fortwährend
das	ART	die
freundlichste	ADJA	freundlich
Verhältniß	NN	Verhältniß
zwischen	APPR	zwischen
dem	ART	die
Regiment	NN	Regiment
,	$,	,
der	ART	die
Bürger	NN	Bürger
=	$(	=
und	KON	und
Einwohnerschaft	NN	Einwohnerschaft
.	$.	.
So	ADV	so
gerne	ADV	gerne
hätten	VAFIN	haben
wir	PPER	wir
noch	ADV	noch
dem	ART	die
Offizierkorps	NN	Offizierkorps
öffentliche	ADJA	öffentlich
Beweise	NN	Beweis
unserer	PPOSAT	unser
Hochachtung	NN	Hochachtung
,	$,	,
unseres	PPOSAT	unser
Wohlwollens	NN	Wohlwollen
gegeben	VVPP	geben
,	$,	,
allein	ADV	allein
der	ART	die
deßhalb	ADJA	deßhalb
gemachte	ADJA	gemacht
Antrag	NN	Antrag
wurde	VAFIN	werden
von	APPR	von
dem	ART	die
Kommandeur	NN	Kommandeur
,	$,	,
wahrscheinlich	ADJD	wahrscheinlich
gegen	APPR	gegen
seinen	PPOSAT	sein
Willen	NN	Wille
und	KON	und
in	APPR	in
Folge	NN	Folge
erhaltener	ADJA	erhalten
Instruktionen	NN	Instruktion
abgelehnt	VVPP	ablehnen
.	$.	.
Schroff	ADJD	schroff
und	KON	und
abgeschlossen	ADJD	abgeschlossen
soll	VMFIN	sollen
das	ART	die
stehende	ADJA	stehend
Heer	NN	Heer
denjenigen	PDAT	derjenig
feindlich	ADJD	feindlich
gegenüberstehen	VVINF	gegenüberstehen
,	$,	,
von	APPR	von
denen	PRELS	die
es	PPER	es
bezahlt	VVPP	bezahlen
wird	VAFIN	werden
,	$,	,
von	APPR	von
der	ART	die
steuerpflichtigen	ADJA	steuerpflichtig
Bürgerschaft	NN	Bürgerschaft
.	$.	.
Jede	PIAT	jede
freundliche	ADJA	freundlich
innige	ADJA	innig
Berührung	NN	Berührung
muß	VMFIN	müssen
vermieden	VVPP	vermeiden
werden	VAINF	werden
.	$.	.
Ein	ART	eine
hochmüthiger	ADJA	hochmüthiger
Kasten	NN	Kasten|Kaste
=	$(	=
Geist	NN	Geist
soll	VMFIN	sollen
die	ART	die
Brust	NN	Brust
des	ART	die
Soldaten	NN	Soldat
allen	PIAT	alle
Gefühlen	NN	Gefühl
verschließen	VVINF	verschließen
,	$,	,
die	PRELS	die
ihn	PPER	er
sonst	ADV	sonst
an	APPR	an
den	ART	die
heimathlichen	ADJA	heimathlichen
Boden	NN	Boden
,	$,	,
an	APPR	an
Freunde	NN	Freund
und	KON	und
Verwandte	NN	Verwandte
bände	VVFIN	binden
,	$,	,
damit	KOUS	damit
er	PPER	er
ein	ART	eine
um	APPR	um
so	ADV	so
willfährigeres	ADJA	willfährigeres
Werkzeug	NN	Werkzeug
wird	VAFIN	werden
.	$.	.
Wir	PPER	wir
gestehen	VVFIN	gestehen
,	$,	,
daß	KOUS	dass
jene	PDAT	jen
Ablehnung	NN	Ablehnung
uns	PRF	wir
gleich	ADJD	gleich
sehr	ADV	sehr
kränkte	VVFIN	kränken
,	$,	,
als	KOUS	als
befremdete	VVFIN	befremden
.	$.	.
